abditive=remote=remote
abear=to bear=bear
abigail=a lady's maid=maid
abiotrophy=degeneration=degeneration
abject=humble=humble
ablepsia=blindness=blindness
abodement=an omen=omen
abomasum=ruminant's fourth stomach=ruminant
abord=to accost=accost
aborning=during birth=birth
aboutsledge=largest blacksmith's hammer=hammer
abrosia=fasting=fasting
abscission=cutting off=cutting
absentaneous=done in absence=done
absinthial=pertaining to wormwood=wormwood
absonant=discordant=discordant
absquatulate=to decamp=decamp
abusion=misuse=misuse
acantha=prickle=prickle
acanthous=spiny=spiny
acarology=study of mites=mites
acarpous=sterile=sterile
acatour=provisioner=provisioner
acaudate=tailless=tailless
accend=to kindle=kindle
accensor=acolyte=acolyte
accentor=songbird=songbird
accidie=sloth=sloth
accinge=to gird=gird
accite=to cite=cite
accolent=neighbouring=neighbouring
accourage=to encourage=encourage
accourt=to entertain=entertain
accoy=to subdue=subdue
accretion=accumulation=accumulation
acedia=listlessness=listlessness
aceology=therapeutics=therapeutics
acerbate=to embitter=embitter
acervate=heaped=heaped
achroous=colourless=colourless
acinaceous=full of kernels=kernels
acipenser=sturgeon=sturgeon
acock=defiantly=defiantly
acolous=limbless=limbless
acracy=government by none=none
acratia=impotence=impotence
acroamatic=esoteric=esoteric
acrologic=pertaining to initials=initials
acrophobia=fear of heights=heights
acrotism=absence of pulsing=pulsing
aculeate=prickly=prickly
acuminate=tapered=tapered
acutiator=sharpener of weapons=weapons
adamantine=unbreakable=unbreakable
addle=putrid=putrid
adeciduate=evergreen=evergreen
adenology=study of glands=glands
adharma=unrighteousness=unrighteousness
adhibit=to attach=attach
adiaphoresis=absence of perspiration=perspiration
adjudge=to decide=decide
adjutage=nozzle=nozzle
adjutor=helper=helper
adnomination=punning=punning
adoral=near the mouth=near
adscititious=added=added
adunc=hooked=hooked
adust=burnt=burnt
adventitious=accidental=accidental
advesperate=darken=darken
adynamia=helplessness=helplessness
aegis=protection=protection
aerolite=meteorite=meteorite
aerolithology=study of aerolites=aerolites
aesthesia=sensibility=sensibility
aestival=pertaining to summer=summer
aeviternal=everlasting=everlasting
affeer=to assess=assess
affiance=to trust=trust
afflated=inspired=inspired
afflatus=inspiration=inspiration
affreux=frightening=frightening
affusion=pouring on=pouring
aftergame=rematch=rematch
afterhand=subsequently=subsequently
agacerie=allurement=allurement
agalloch=eaglewood=eaglewood
agapet=lover of women=women
agapism=ethics of love=ethics
agathodaimon=one's good genius=one
agennesic=sterile=sterile
aggerose=in heaps=heaps
agminate=grouped=grouped
agnation=kinship=kinship
agnosy=ignorance=ignorance
agone=ago=ago
agonic=making no angle=angle
agonism=competition=competition
agraphia=inability to write=write
agravic=having no gravity=gravity
agrestic=of the fields=fields
agrize=to horrify=horrify
agrostography=writing about grasses=grasses
agrypnia=insomnia=insomnia
aiguille=sharp=sharp
ailurophilia=love of cats=cats
ailurophobia=fear of cats=cats
aiué=elderly=elderly
akeratophorous=not horned=horned
alate=lately=lately
alaudine=pertaining to skylarks=skylarks
albe=although=although
albicant=whitish=whitish
alcine=pertaining to elks=elks
alethiology=study of truth=truth
alexia=inability to read=read
alexipharmic=antidote=antidote
algefacient=cooling=cooling
algicide=killer of algae=killer
algid=cold=cold
algology=study of algae=algae
algophobia=fear of pain=pain
algor=coldness=coldness
alible=nourishing=nourishing
aligerous=winged=winged
aliunde=from elsewhere=elsewhere
alliaceous=pertaining to garlic=garlic
allogeneous=different=different
allwhere=elsewhere=elsewhere
almoner=giver of alms=giver
alnager=inspector of cloth=inspector
alopecia=baldness=baldness
alopecoid=of  a fox=fox
alternatim=alternately=alternately
alveary=beehive=beehive
alviducous=purgative=purgative
alvine=of the belly=belly
amadelphous=outgoing=outgoing
amaranthine=immortal=immortal
amasesis=inability to chew=inability
amathophobia=fear of dust=dust
ambages=windings=windings
ambit=circuit=circuit
ambulophobia=fear of walking=walking
amerce=to fine=fine
ampelidious=pertaining to vines=vines
amphibology=ambiguity in language=language
amphimixis=interbreeding=interbreeding
amplect=to embrace=embrace
ampliative=supplemental=supplemental
amyloid=pertaining to starch=starch
anacardic=pertaining to cashews=cashews
anaclastic=refractive=refractive
anaerectic=destructive=destructive
anaesthesiology=study of anaesthetics=anaesthetics
analemma=sundial=sundial
anamnesis=reminiscence=reminiscence
anandrious=impotent=impotent
anastasic=convalescent=convalescent
anatine=pertaining to ducks=ducks
anatreptic=overcoming=overcoming
anaudia=loss of voice=voice
anaunter=on the chance=chance
ancillary=auxiliary=auxiliary
ancon=elbow=elbow
androcracy=government by men=men
andromania=nymphomania=nymphomania
androphagy=cannibalism=cannibalism
aneabil=single=single
anear=nearly=nearly
anemology=study of winds=winds
anemophilous=pollinated by wind=wind
anencephalic=lacking a brain=lacking
angelocracy=government by angels=government
angelology=study of angels=angels
anguine=pertaining to snakes=snakes
anhelation=shortness of breath=shortness
anhidrosis=absence of perspiration=perspiration
anile=imbecilic=imbecilic
animastic=spiritual=spiritual
annomination=pun=pun
annulose=ringed=ringed
anocathartic=emetic=emetic
anodontia=toothlessness=toothlessness
anomphalous=without a navel=without
anopsia=blindness=blindness
anserine=pertaining to geese=geese
antarchy=opposition to government=opposition
anteambulo=usher=usher
antejentacular=before breakfast=breakfast
anteloquy=a preface=preface
antepast=foretaste=foretaste
antepone=to put before=put
anteprandial=before dinner=dinner
antevenient=preceding=preceding
anthomania=obsession with flowers=obsession
anthrophobia=fear of humans=humans
anthropophaginian=cannibal=cannibal
anticryptic=camouflaged=camouflaged
antilogy=contradiction=contradiction
antimnemonic=damaging the memory=memory
antre=cave=cave
anuresis=inability to urinate=urinate
anurous=tailless=tailless
apanage=privilege of office=privilege
apay=to satisfy=satisfy
aperient=laxative=laxative
aphicide=killer of aphids=killer
aphidicide=killer of aphids=killer
aphnology=science of wealth=wealth
aphologistic=flameless=flameless
aphotic=lightless=lightless
aphrasia=inability to speak=speak
apian=pertaining to bees=bees
apiculture=beekeeping=beekeeping
apiology=study of bees=bees
apistia=faithlessness in marriage=marriage
apocarteresis=suicide by starvation=suicide
aponia=painlessness=painlessness
apopemptic=valedictory=valedictory
appendant=attached to=attached
applanate=flat=flat
apposite=appropriate=appropriate
approbation=approval=approval
apprompt=to borrow=borrow
appropinquity=nearness=nearness
aprique=sunny=sunny
apterygial=wingless=wingless
aptotic=uninflected=uninflected
aquaphobia=fear of water=water
aquiform=watery=watery
aquiline=pertaining to eagles=eagles
arachnivorous=feeding on spiders=spiders
arachnology=study of spiders=spiders
arachnophobia=fear of spiders=spiders
araneidan=pertaining to spiders=spiders
araneous=transparent=transparent
araphorostic=seamless=seamless
aration=ploughing=ploughing
arbalest=type of crossbow=type
arborescent=branched=branched
arboricide=killing of trees=trees
arbrolatry=worship of start=worship
arbustum=orchard=orchard
arceate=to prevent=prevent
archididascalian=pertaining to headmasters=headmasters
arcuate=arched=arched
arefy=to dry up=dry
arenoid=sandy=sandy
areology=study of Mars=mars
argentocracy=government by money=money
argillaceous=clayey=clayey
argute=shrill=shrill
arietine=pertaining to rams=rams
aright=right=right
ariolation=divination in general=general
aroint=begone=begone
arrant=downright=downright
arrect=attentive=attentive
arreptitious=ecstatic=ecstatic
arrosive=gnawing=gnawing
arthrology=study of joints=joints
asinine=pertaining to asses=asses
asitia=lack of appetite=lack
asomatous=lacking a body=lacking
asperge=to sprinkle=sprinkle
asperse=slander=slander
assoil=to absolve=absolve
assot=to befool=befool
assuefaction=habituation=habituation
assuetude=accustomedness=accustomedness
assurgent=ascending=ascending
astatic=in equilibrium=equilibrium
astichous=not in rows=rows
astrolatry=worship of stars=worship
astrut=protrudingly=protrudingly
atactic=irregular=irregular
ataraxia=tranquility=tranquility
ateknia=childlessness=childlessness
athanasy=deathlessness=deathlessness
athwart=across=across
athymia=melancholy=melancholy
atimy=loss of honour=loss
atrabiliary=melancholy=melancholy
atrabilious=melancholy=melancholy
atrament=blacking=blacking
atrichia=baldness=baldness
attaint=disgrace=disgrace
attingent=touching=touching
attollent=lifting up=lifting
attrist=to sadden=sadden
aubergine=eggplant=eggplant
audiology=study of hearing=hearing
augean=filthy=filthy
aulete=flautist=flautist
aulic=courtly=courtly
aurifex=goldsmith=goldsmith
aurigation=charioteering=charioteering
austringer=keeper of goshawks=keeper
autocide=killing of oneself=oneself
autophobia=fear of solitude=solitude
auxesis=increase in size=size
auxology=science of growth=growth
avaunt=away=away
averruncate=to ward off=ward
avicide=killing of birds=killing
avicular=pertaining to birds=birds
avital=ancestral=ancestral
avolitional=involuntary=involuntary
avuncular=like an uncle=uncle
axilla=armpit=armpit
azuline=blue=blue
azymous=unleavened=unleavened
baboonery=foolishness=foolishness
baccate=having berries=berries
bacchanal=drunkard=drunkard
bacillicide=killer of berries=killer
bactericide=killer of bacteria=killer
balanism=use of suppositories=use
balatron=joker=joker
balbutient=stammering=stammering
balderdash=nonsense=nonsense
balistarius=crossbowman=crossbowman
ballistophobia=fear of missiles=missiles
balneary=bath=bath
banausic=materialistic=materialistic
bantling=brat=brat
barathrum=an abyss=abyss
barbarocracy=government by barbarians=government
barbate=bearded=bearded
barbigerous=bearded=bearded
barcarole=gondolier's song=song
barm=yeast=yeast
barmcloth=an apron=apron
barology=study of gravitation=gravitation
barracoon=depot for slaves=slaves
barton=farmyard=farmyard
baryecoia=deafness=deafness
basial=pertaining to kissing=kissing
basiation=kissing=kissing
basilicon=kind of ointment=ointment
bassinet=light, conical helmet=light
bating=except=except
bavardage=chattering=chattering
bdelloid=pertaining to leeches=leeches
beblubbered=disfigured from weeping=weeping
beforetime=formerly=formerly
belcher=coloured=coloured
belike=most likely=likely
belling=deer's mating call=deer
benefic=kindly=kindly
benet=exorcist=exorcist
berceuse=lullaby=lullaby
besom=curler's broom=curler
bestiocracy=rule by beasts=rule
bewray=to reveal=reveal
bibelot=trinket=trinket
bibitory=pertaining to drinking=drinking
bibliogenesis=production of books=production
bibliology=study of books=books
bibliopegist=bookbinder=bookbinder
bibliophobia=fear of books=books
bibliopoesy=making of books=books
bibliopolist=bookseller=bookseller
bibliopoly=bookselling=bookselling
bibulous=addicted to alcohol=alcohol
biggin=a building=building
binate=doubled=doubled
biramous=forked=forked
bis=twice=twice
bismer=shame=shame
bisontine=pertaining to bison=bison
bivious=offering a choice=offering
blackguard=to vituperate=vituperate
blackmaster=undertaker=undertaker
blastogenesis=reproduction by budding=reproduction
blattoid=pertaining to cockroaches=cockroaches
blendling=hybrid=hybrid
blendure=mixing=mixing
blennoid=of  mucus=mucus
blennophobia=fear of slime=slime
blepharal=pertaining to eyelids=eyelids
boeotian=stupid=stupid
boethetic=helpful, curative=helpful
boggart=spectre=spectre
bolar=pertaining to clay=clay
bombic=pertaining to silkworms=silkworms
bombosity=the buttocks=buttocks
bombous=convex=convex
bonasus=bison=bison
bongre=agreeably=agreeably
borné=limited=limited
bosket=thicket=thicket
bosselated=knobby=knobby
bosun=boatswain=boatswain
bouleversement=overturning=overturning
boun=to prepare=prepare
bourasque=tempest=tempest
bovicide=slaughter of cattle=slaughter
brachet=whelp=whelp
brackish=saltish=saltish
branchial=pertaining to gills=gills
brank=to prance=prance
breme=fierce=fierce
bridewell=house of corrections=house
brigue=to intrigue=intrigue
brobdingnagian=immense=immense
broma=food=food
bromatology=study of food=food
brumal=pertaining to winter=winter
brumous=foggy=foggy
bummel=stroll=stroll
burrole=an eavesdropper=eavesdropper
bushwa=nonsense=nonsense
buteonine=pertaining to buzzards=buzzards
butyric=pertaining to butter=butter
byssine=silky=silky
byssoid=fibrous=fibrous
cabrie=a pronghorn=pronghorn
cack=rubbish=rubbish
caduceator=herald=herald
caecity=blindness=blindness
cafard=depression=depression
caitiff=base=base
calamist=piper=piper
calceate=to shoe=shoe
calcimine=to whitewash=whitewash
calefacient=warming=warming
calescence=increase in heat=increase
caliginous=misty=misty
calipace=turtle's carapace=turtle
calix=cup=cup
callant=boy=boy
callow=unfledged=unfledged
calorifics=study of heat=heat
calumniate=to slander=slander
calvities=baldness=baldness
calvous=bald=bald
cameline=pertaining to camels=camels
camelopard=giraffe=giraffe
camsteary=perverse=perverse
canaille=riffraff=riffraff
cancerophobia=fear of cancer=cancer
cancrine=pertaining to crabs=crabs
candent=heated to whiteness=whiteness
canescent=hoary=hoary
canorous=musical=musical
cantative=pertaining to singing=singing
capelocracy=government by shopkeepers=shopkeepers
capillaceous=hairlike=hairlike
capistrate=hooded=hooded
capitation=numbering of individuals=numbering
caple=a horse=horse
capreolate=having  tentacles=tentacles
capriform=goatlike=goatlike
caprine=pertaining to goats=goats
capripede=satyr=satyr
captious=peevish=peevish
carceral=pertaining to prisons=prisons
cardialgia=heartburn=heartburn
cardophagus=donkey=donkey
caricology=study of sedges=sedges
caricous=pertaining to figs=figs
caritative=generous=generous
carneous=fleshy=fleshy
carnifex=executioner=executioner
carnification=conversion into flesh=flesh
carnificine=place of execution=place
carnose=fleshy=fleshy
carpology=study of fruit=fruit
carrack=galleon=galleon
casque=helmet=helmet
cassation=annulment=annulment
catachthonian=underground=underground
cataclasm=disruption=disruption
catalactic=pertaining to exchange=exchange
catalectic=incomplete=incomplete
cataphract=suit of mail=suit
cataphysical=unnatural=unnatural
catastaltic=astringent=astringent
catchpole=constable=constable
catenarian=pertaining to chains=chains
cathisophobia=fear of sitting=sitting
catogenic=formed from above=formed
cautelous=treacherous=treacherous
cecity=blindness=blindness
cedrate=citron=citron
celation=concealment=concealment
celsitude=loftiness=loftiness
cenatory=pertaining to supper=supper
cenobite=monk=monk
cephalate=having a head=head
cerated=covered with wax=wax
cerberic=vigilant=vigilant
certes=in truth=truth
cervisial=pertaining to beer=beer
cespitous=composed of  turf=turf
chalastic=laxative=laxative
chanticleer=a rooster=rooster
chartaceous=papery=papery
chasseur=hunter=hunter
chawdron=entrails=entrails
cheiloproclitic=attracted to lips=lips
chersonese=peninsula=peninsula
chesil=gravel=gravel
cheverel=soft=soft
chevisance=resource=resource
chiffonier=chest of drawers=drawers
chiliastic=millenarian=millenarian
chimerical=imaginary=imaginary
chirapsia=massage=massage
chirk=cheer=cheer
chirocosmetics=beautifying the hands=hands
chirospasm=writer's cramp=writer
chlamys=horseman's loose cloak=horseman
cholic=pertaining to bile=bile
chondrogenesis=production of cartilage=production
chouse=to cheat=cheat
chrematophobia=fear of money=money
Christolatry=worship of Christ=worship
cibarious=pertaining to food=food
cicatrization=scarification=scarification
cicerone=guide=guide
ciconine=pertaining to storks=storks
cimelia=treasures in storage=treasures
cimex=bedbug=bedbug
cimier=crest of helmet=helmet
cinerary=pertaining to ashes=ashes
cinerious=ashen=ashen
cippus=the stocks=stocks
circumambagious=roundabout in speech=speech
cirrate=having tendrils=tendrils
cladose=branching=branching
clamancy=urgency=urgency
clamant=loud=loud
classis=a group=group
claudent=closing=closing
claudication=limpness=limpness
claustral=cloistral=cloistral
claver=gossip=gossip
claviature=keyboard=keyboard
clavis=key=key
clem=to starve=starve
clepe=to name=name
cleronomy=inheritance=inheritance
clicket=a latch=latch
clinamen=inclination=inclination
clinophilia=passion for beds=passion
clinquant=tinselly=tinselly
clivose=hilly=hilly
cloaca=sewer=sewer
clochard=tramp=tramp
cloison=partition=partition
clonic=spasmodic=spasmodic
clough=ravine=ravine
clupeoid=like  a herring=like
clyster=enema=enema
coacervate=to heap=heap
coadunate=to unite=unite
coarctation=constriction=constriction
cockamamie=ridiculous=ridiculous
cocker=to pamper=pamper
cocotte=prostitute=prostitute
coctile=baked=baked
codicology=study of manuscripts=manuscripts
coenaculous=fond of dining=fond
coenaesthesis=sensation=sensation
cogent=convincing=convincing
coggage=paper=paper
cogitabund=meditative=meditative
cohibit=to restrain=restrain
cohobate=to redistill=redistill
coign=angle=angle
coinstantaneous=simultaneous=simultaneous
colation=filtration=filtration
collectanea=collection of passages=passages
collectic=adhesive=adhesive
colluctation=strife=strife
collutory=mouthwash=mouthwash
colostrum=mother's first milk=mother
colubrine=like a snake=snake
colytic=restraining=restraining
comate=hairy=hairy
comburent=burning=burning
comburivorous=consuming by fire=fire
cometology=study of comets=comets
comiphorous=tufted=tufted
comity=courteousness=courteousness
commination=threatening=threatening
commis=assistant=assistant
commissure=joint=joint
commonition=warning=warning
commove=to excite=excite
compaginate=to join=join
compendious=concise but comprehensive=concise
compital=pertaining to crossroads=crossroads
complanate=level=level
complect=to embrace=embrace
complicant=overlapping=overlapping
compunction=regret=regret
compusion=wrinkling one's face=face
concameration=vaulting=vaulting
conchiferous=bearing a shell=shell
conchology=study of shells=shells
conchyliferous=bearing a shell=shell
concinnity=harmony=harmony
concipient=conceiving=conceiving
concision=schism=schism
concomitant=accompanying=accompanying
confabulate=to chat=chat
congee=permission to depart=permission
congeries=aggregation=aggregation
connubial=pertaining to marriage=marriage
consectary=deduction=deduction
consentient=unanimous=unanimous
consilience=concurrence=concurrence
conspue=to despise=despise
conspurcation=defilement=defilement
constate=to assert=assert
constellate=to cluster=cluster
constuprate=to ravish=ravish
consuetude=custom=custom
conteck=strife=strife
conticent=silent=silent
contraposition=opposition=opposition
contrist=to sadden=sadden
contriturate=to pulverize=pulverize
contumacious=stubborn=stubborn
contumely=insolence=insolence
convicinity=neighbourhood=neighbourhood
copacetic=very satisfactory=satisfactory
cophosis=deafness=deafness
coprology=study of pornography=pornography
copromania=obsession with feces=obsession
coprostatis=constipation=constipation
cordwainer=shoemaker=shoemaker
corella=cockateel=cockateel
cornigerous=horned=horned
cornuted=cuckolded=cuckolded
cornuto=cuckolder=cuckolder
correption=shortening in pronunciation=shortening
cortege=train of attendants=train
cortinate=like a cobweb=like
coruscate=to sparkle=sparkle
coryphaeus=spokesman=spokesman
cosmetology=study of cosmetics=cosmetics
costellate=ribbed=ribbed
coteau=uplands=uplands
cothurnal=pertaining to tragedy=tragedy
coticular=pertaining to whetstones=whetstones
couloir=gully=gully
coulrophobia=fear of clowns=clowns
countenance=approve of=approve
courgette=zucchini=zucchini
couveuse=incubator for babies=incubator
covinous=fraudulent=fraudulent
crachoir=spittoon=spittoon
crackjaw=hard to pronounce=pronounce
cramoisy=crimson=crimson
crapehanger=pessimist=pessimist
crasis=blending=blending
creant=creating=creating
creatic=pertaining to flesh=flesh
creatophagous=carnivorous=carnivorous
crebrous=frequent=frequent
crenate=scalloped=scalloped
crenellated=notched=notched
crepehanger=pessimist=pessimist
crepitate=to crackle=crackle
crepitus=fart=fart
crepuscular=pertaining to twilight=twilight
crescive=growing=growing
cretaceous=of  chalk=chalk
criant=garish=garish
cribration=sifting=sifting
criminology=study of crime=crime
crinigerous=hairy=hairy
crotaline=pertaining to rattlesnakes=rattlesnakes
cruciferous=bearing a cross=cross
crumenal=a purse=purse
cruset=goldsmith's crucible=goldsmith
cryptous=pertaining to crypts=crypts
crystallogenesis=production of crystals=production
cuculine=pertaining to cuckoos=cuckoos
cucullate=hooded=hooded
cucurbitaceous=pertaining to gourds=gourds
culex=mosquito=mosquito
culiciform=like  a mosquito=mosquito
cumbent=lying down=lying
cunabula=cradle=cradle
cunctation=delay=delay
curtal=short=short
curtate=shortened=shortened
curvet=to leap=leap
cuspidor=a spittoon=spittoon
cyanogenesis=production of cyanide=production
cyanotype=blueprint=blueprint
cyberphobia=fear of computers=computers
cyclosis=circulation=circulation
cyesis=pregnancy=pregnancy
cymophanous=opalescent=opalescent
cynolatry=worship of dogs=worship
cynophobia=fear of dogs=dogs
cyprinoid=pertaining to carp=carp
cypseline=pertaining to swifts=swifts
cytheromania=nymphomania=nymphomania
cytogenesis=formation of cells=formation
dacnomania=obsession with killing=obsession
dactyliology=study of rings=rings
dactylogram=fingerprint=fingerprint
dactyloid=like  a finger=like
daedal=formed with art=formed
daedalist=aviator=aviator
dapatical=lavish=lavish
darbies=handcuffs=handcuffs
darraign=to vindicate=vindicate
daw=simpleton=simpleton
deadhouse=mortuary=mortuary
dealbation=whitening=whitening
dearticulate=to disjoint=disjoint
debarrass=to disembarrass=disembarrass
decession=departure=departure
decollate=to behead=behead
decrepitate=to crackle=crackle
decuman=principle=principle
decumbent=lying down=lying
dedition=surrender=surrender
deek=look at=look
defervescence=abatement of heat=heat
deflexure=deviation=deviation
defluent=running down=running
defluvium=falling of hair=hair
dégagé=at rest=rest
dehisce=to gape=gape
dehors=outside of=outside
dehort=to dissuade=dissuade
deiparous=bearing a god=god
delactation=weaning=weaning
delate=to pass on=pass
delf=drain=drain
delibate=to sip=sip
deligation=bandaging=bandaging
deliration=madness=madness
delitescent=latent=latent
delphically=enigmatically=enigmatically
delphinine=pertaining to dolphins=dolphins
demerge=to immerse=immerse
demersal=subaqueous=subaqueous
demigration=change of abode=change
demonology=study of demons=demons
demulcent=emulsifier=emulsifier
denary=one of ten=ten
dendritiform=branched=branched
dendrolatry=worship of trees=worship
dendrology=study of trees=trees
dendrophilous=fond of trees=trees
dentagra=toothache=toothache
dentelle=lace=lace
dentigerous=toothed=toothed
deonerate=to disburden=disburden
depascent=eating=eating
deprehend=to catch=catch
depurate=to purify=purify
deracinate=to root up=root
dermatology=study of skin=skin
descrive=to describe=describe
desinent=terminal=terminal
desipient=playing the fool=playing
desmology=study of ligaments=ligaments
despoliation=despoiling=despoiling
desuetude=state of disuse=state
detort=to untwist=untwist
detumescence=diminution of swelling=swelling
devall=to sink=sink
devoir=what is due=due
dewlap=turkey's wattle=wattle
diablerie=magic=magic
diabology=study of devils=devils
diabrotic=corrosive=corrosive
diacatholicon=panacea=panacea
diachoretic=laxative=laxative
diaclastic=refractory=refractory
diacritic=making a distinction=distinction
dialectology=study of dialects=dialects
diamanté=glittering=glittering
dianoetic=pertaining to thought=thought
diaphanous=transparent=transparent
diaskeuast=reviser=reviser
diaspora=dispersion=dispersion
diastema=space between teeth=teeth
dicacity=raillery=raillery
didascalic=didactic=didactic
didelphine=pertaining to opossums=opossums
didine=pertaining to dodos=dodos
didymous=twin=twin
diffugient=dispersing=dispersing
dight=disposed, adorned, clothed=disposed
digitate=having  fingers=fingers
dijudicate=to judge=judge
dilatory=slow=slow
dilogical=ambiguous=ambiguous
diluent=diluting=diluting
diluvial=pertaining to floods=floods
dimidiate=divided into halves=halves
dinomania=mania for dancing=mania
diogenic=cynical=cynical
dioptric=transparent=transparent
diorism=distinction=distinction
diotic=affecting both ears=ears
diplomatology=study of diplomats=diplomats
diremption=separation into two=two
dirigent=guiding=guiding
discarnate=disembodied=disembodied
discept=to dispute=dispute
discinct=ungirded=ungirded
discombobulate=to disconcert=disconcert
discommodious=inconvenient=inconvenient
discophoran=pertaining to jellyfishes=jellyfishes
discountenance=to abash=abash
disgarnish=to despoil=despoil
disgregation=separation=separation
disimmure=to liberate=liberate
dispendious=extravagant=extravagant
dispiteous=pitiless=pitiless
dissentient=one who dissents=one
dissimulate=to pretend=pretend
distraint=seizure of goods=seizure
distrait=distracted=distracted
dit=poem=poem
dithyrambic=passionate=passionate
divagate=to digress=digress
divisim=separately=separately
dixit=individual's uncorroborated statement=individual
dizen=to dress up=dress
dobbin=workhorse=workhorse
dobhash=interpreter=interpreter
docimasy=scrutiny=scrutiny
dolent=mourning=mourning
doomster=judge=judge
dorsad=towards the back=towards
dossil=plug=plug
doulocracy=government by slaves=slaves
doxastic=pertaining to opinion=opinion
drabble=to besmear=besmear
draffish=worthless=worthless
dragoman=interpreter=interpreter
drepanoid=like a sickle=sickle
drollery=drollness=drollness
dubiety=doubtfulness=doubtfulness
dubitate=to doubt=doubt
dudgeon=resentment=resentment
duenna=governess=governess
dulocracy=government by slaves=slaves
dumose=bushy=bushy
duncical=stupid=stupid
duramen=heartwood=heartwood
durative=continuing=continuing
dure=to last=last
durity=hardness=hardness
duteous=devoted to duty=duty
dysaesthesia=loss of sensation=sensation
dysbulia=loss of willpower=willpower
dysphoria=uneasiness=uneasiness
ebullition=boiling over=boiling
ecaudate=tailless=tailless
ecbole=digression=digression
eccaleobion=incubator=incubator
eccoprotic=laxative=laxative
eccrinology=study of excretion=excretion
ecdemic=not endemic=endemic
echinate=like a hedgehog=like
eclaircise=to clear up=clear
éclaircissement=clarification=clarification
éclat=publicity=publicity
ecophobia=fear of home=home
ectypography=etching in relief=relief
edacious=voracious=voracious
edaphology=study of soils=soils
edentate=toothless=toothless
edulcorate=to sweeten=sweeten
eellogofusciouhipoppokunurious=good=good
effodient=burrowing=burrowing
effulge=to shine out=shine
effutiation=twaddle=twaddle
eft=a newt=newt
eftsoons=soon after=soon
egency=need=need
eidolism=belief in ghosts=ghosts
eikonology=metaphor=metaphor
eke=in addition=addition
élan=impetuosity=impetuosity
elapid=pertaining to cobras=cobras
elchee=ambassador=ambassador
eldritch=horrifying=horrifying
electrogenesis=production of electricity=production
electrology=study of electricity=electricity
elenchus=refutation=refutation
elenctic=pertaining to argument=argument
elephantine=pertaining to elephants=elephants
eleutherophobia=fear of freedom=freedom
elide=omit=omit
elsin=shoemaker's awl=shoemaker
emarcid=wilted=wilted
embale=to enclose=enclose
embar=to shut in=shut
embase=to lower=lower
embayment=bay=bay
emberlucock=to confuse=confuse
embonpoint=stout=stout
emendation=correction=correction
emetology=study of vomiting=vomiting
emicate=to sparkle=sparkle
emmet=ant=ant
emollient=softening=softening
emolument=payment=payment
empennage=airplane's tail unit=airplane
emporeutic=pertaining to trade=trade
empyreal=pertaining to heaven=heaven
enantiopathy=allopathy=allopathy
enation=outgrowth=outgrowth
enceinte=pregnant=pregnant
encephaloid=like  a brain=like
encolpion=reliquary=reliquary
endeixis=an indication=indication
endlong=lengthwise=lengthwise
endocrinology=study of glands=glands
enervate=to weaken=weaken
engastrimyth=ventriloquist=ventriloquist
enigmatology=study of enigmas=enigmas
enjoin=to command=command
ennomic=lawful=lawful
enosis=union=union
enounce=to enunciate=enunciate
enow=enough=enough
entomical=pertaining to insects=insects
entomology=study of insects=insects
entoptic=within the eyeball=within
entresol=mezzanine=mezzanine
environ=around=around
enzymology=study of enzymes=enzymes
eoan=pertaining to dawn=dawn
eosophobia=fear of dawn=dawn
epaenetic=eulogistic=eulogistic
epagoge=induction=induction
epagomenal=intercalary=intercalary
epanalepsis=repetition=repetition
epeolatry=worship of words=worship
ephestian=domestic=domestic
epidemiology=study of diseases=diseases
epigraphy=science of inscriptions=inscriptions
epileptology=study of epilepsy=epilepsy
epinician=celebrating a triumph=triumph
epinosic=unhealthy=unhealthy
epipolism=fluorescence=fluorescence
episcopicide=killing of bishops=killing
episcopolatry=worship of bishops=worship
epistatic=suppressing some factor=suppressing
epistolary=pertaining to letters=letters
epithymetic=pertaining to desire=desire
epulary=pertaining to banquets=banquets
epulation=feasting=feasting
equable=smooth=smooth
equine=pertaining to horses=horses
equipoise=equilibrium=equilibrium
erelong=before long=long
eremite=hermit=hermit
eremology=study of deserts=deserts
ergasia=love of work=work
ergasiophobia=fear of work=work
ergo=therefore=therefore
ergophobia=fear of work=work
ergotise=to wrangle=wrangle
erotophobia=fear of sex=sex
eruciform=like  a caterpillar=like
eructate=to belch out=belch
erumpent=bursting out=bursting
escadrille=squadron of aircraft=squadron
escalier=staircase=staircase
escharotic=caustic=caustic
esclandre=notoriety=notoriety
esculent=eatable=eatable
esemplastic=unifying=unifying
esotropic=squinting=squinting
espiègle=roguish=roguish
essorant=soaring=soaring
estival=pertaining to summer=summer
esurient=hungry=hungry
etesian=periodic=periodic
etheromania=craving for ether=ether
etypical=unconformable to type=unconformable
eupathy=state of contentment=state
evagation=wandering=wandering
evanish=to vanish=vanish
evanition=vanishing=vanishing
evirate=to castrate=castrate
eviscerate=disembowel=disembowel
eviternal=eternal=eternal
evulgate=to divulge=divulge
evulse=to pluck out=pluck
exactor=one who exacts=one
exallotriote=foreign=foreign
exanimate=lifeless=lifeless
exarch=viceroy=viceroy
exarchy=government by bishops=government
exaugurate=to desanctify=desanctify
excrementitial=pertaining to excrement=excrement
excresence=outgrowth=outgrowth
excubant=on guard=guard
excursive=constituting a digression=digression
executancy=technique in music=technique
exenterate=to disembowel=disembowel
exercitation=putting into practice=putting
exheredate=to disinherit=disinherit
exiguous=scanty=scanty
exlex=outside the law=outside
exoculate=blind=blind
exodontia=extraction of teeth=teeth
expergefacient=awakening=awakening
explement=complement=complement
expostulate=to remonstrate=remonstrate
exprobate=to reproach=reproach
exscind=to cut off=cut
exsect=to cut out=cut
exsert=to protrude=protrude
exsiccate=to dry up=dry
exspuition=spitting=spitting
eyewash=humbug=humbug
eyne=eyes=eyes
factious=turbulent=turbulent
factotum=lackey=lackey
facture=workmanship=workmanship
facultative=optional=optional
facundity=eloquence=eloquence
fadoodle=nonsense=nonsense
fain=happy=happy
falcate=resembling a sickle=sickle
falderal=nonsense=nonsense
fane=temple=temple
farctate=full=full
farinaceous=mealy=mealy
farouche=wild=wild
farraginous=disordered=disordered
fascicle=bundle=bundle
fastigiate=pointed=pointed
fastigium=roof=roof
fastuous=haughty=haughty
fatidical=prophetic=prophetic
fatuous=silly=silly
faveolate=honeycombed=honeycombed
feague=to whip=whip
feak=lock of hair=lock
featous=shapely=shapely
febricity=feverishness=feverishness
feckless=feeble=feeble
feculent=covered with filth=filth
fenestral=pertaining to windows=windows
feracious=fruitful=fruitful
ferial=pertaining to holidays=holidays
festinate=to accelerate=accelerate
fetial=heraldic=heraldic
fictor=sculptor=sculptor
fiddlededee=nonsense=nonsense
fideicide=killer of faith=killer
fiduciary=held in trust=trust
figuline=pertaining to earthenware=earthenware
filaceous=composed of threads=threads
filibeg=kilt=kilt
filose=threadlike=threadlike
fimbriate=fringed=fringed
fimetic=pertaining to dung=dung
fimicolous=living in dung=living
fingent=moulding=moulding
fitchew=polecat=polecat
flam=humbug=humbug
flammulated=ruddy=ruddy
flânerie=idling=idling
flaught=snowflake=snowflake
fleer=to mock=mock
fleshling=a sensualist=sensualist
flexion=a bend=bend
flimflam=nonsense=nonsense
flinty=unyielding=unyielding
floccose=woolly=woolly
florimania=craze for flowers=flowers
flummadiddle=nonsense=nonsense
fluviology=study of watercourses=watercourses
fluxional=variable=variable
fodient=pertaining to digging=digging
foeticide=killing a fetus=killing
fogram=antiquated=antiquated
foinery=fencing=fencing
foison=plenty=plenty
foolocracy=government by fools=government
foothot=hastily=hastily
footling=inept=inept
foraminate=to pierce=pierce
foraneous=pertaining to forums=forums
forby=past=past
forcipate=pertaining to forceps=forceps
forficate=forked=forked
forinsecal=foreign=foreign
formic=pertaining to ants=ants
formicate=resembling an ant=ant
formicine=pertaining to ants=ants
forsooth=in truth=truth
fortalice=fortress=fortress
forthwith=immediately=immediately
forthy=for this reason=reason
forwhy=for what reason=reason
fossorial=adapted for digging=digging
fossulate=grooved=grooved
foudroyant=thundering=thundering
foumart=polecat=polecat
foursquare=forthright=forthright
foveate=pitted=pitted
fractious=irritable=irritable
fragor=a crash=crash
fremitus=vibration=vibration
fretum=strait=strait
fringillaceous=pertaining to finches=finches
fringilliform=resembling a finch=finch
fringilline=pertaining to finches=finches
frisson=shiver=shiver
frith=peace=peace
fructivorous=feeding on fruit=fruit
fructuous=fruitful=fruitful
frumentarious=pertaining to corn=corn
frutescent=like  a shrub=shrub
fruticose=shrubby=shrubby
fub=to put off=put
fug=hot=hot
fulcrate=supported with fulcrums=supported
fulgent=shining=shining
fulgid=flashing=flashing
fulgorous=flashing=flashing
fulgour=splendour=splendour
fulgural=pertaining to lightning=lightning
fuliginous=sooty=sooty
fuligo=soot=soot
fumosity=condition of fuming=fuming
funest=deadly=deadly
fungible=interchangeable=interchangeable
furacious=thievish=thievish
furcate=forked=forked
furfuraceous=branny=branny
furibund=raging=raging
furuncular=pertaining to boils=boils
furunculoid=like a boil=like
fuscous=brown=brown
fusillation=death by shooting=shooting
fustigate=to cudgel=cudgel
futurology=study of future=future
gabbart=barge=barge
gadarene=headlong=headlong
galbanum=nonsense=nonsense
galimatias=nonsense=nonsense
galliard=brisk=brisk
gallicide=killer of fowl=killer
gallionic=uncaring=uncaring
gambrel=horse's hock=horse
gametogenesis=formation of gametes=gametes
gamic=sexual=sexual
gamidolatry=worship of marriage=worship
gaminesque=playful=playful
gamophobia=fear of marriage=marriage
gantry=shelving for barrels=shelving
garbology=study of garbage=garbage
gargarize=to gargle=gargle
garner=granary=granary
gasconism=boastfulness=boastfulness
gastriloquist=ventriloquist=ventriloquist
gastroenterology=study of stomach=stomach
gastrolatry=gluttony=gluttony
gaumless=stupid=stupid
geist=spirit=spirit
gelation=solidification by cooling=solidification
gemel=twinned=twinned
gement=groaning, lamenting=lamenting
geminate=to double=double
geminiform=paired=paired
gemmation=budding=budding
gemmeous=pertaining to gems=gems
genetrix=mother=mother
geniophobia=fear of chins=chins
genophobia=fear of sex=sex
geoponic=agricultural=agricultural
geoponics=study of agriculture=agriculture
gestatorial=pertaining to carrying=carrying
gestic=pertaining to gestures=gestures
gewgaw=toy=toy
gibbet=gallows=gallows
gigantology=study of giants=giants
gigot=leg of mutton=mutton
gilliver=wallflower=wallflower
gimcrack=trick=trick
glabrous=hairless=hairless
glaireous=slimy=slimy
glareous=gravelly=gravelly
glebe=sod=sod
glebous=earthy=earthy
gliriform=resembling a rodent=rodent
glochidiate=bristled=bristled
glossa=the tongue=tongue
glossography=writing of glossaries=glossaries
glossoid=like a tongue=tongue
glossology=study of language=language
glozing=flattery=flattery
glutinous=gluey=gluey
glutition=swallowing=swallowing
glycogenesis=production of glycogen=production
gnathonic=flattering=flattering
gnosiology=study of knowledge=knowledge
gnosis=knowledge=knowledge
goatish=lustful=lustful
goitrous=pertaining to goitre=goitre
goluptious=delightful=delightful
gonoph=pickpocket=pickpocket
gormandism=gluttony=gluttony
gossypine=cottony=cottony
gowk=a cuckoo=cuckoo
gracility=slenderness=slenderness
gradatim=step by step=step
graip=pitchfork=pitchfork
gramary=magic=magic
gramineous=pertaining to grass=grass
graminology=study of grasses=grasses
grandiloquent=bombastic=bombastic
grandinous=full of hail=hail
granivorous=feeding on seeds=seeds
graphology=study of handwriting=handwriting
graphomania=obsession with writing=obsession
graphophobia=fear of writing=fear
graphospasm=writer's cramp=writer
gratulatory=congratulatory=congratulatory
gravamen=grievance=grievance
gravid=pregnant=pregnant
gregatim=in flocks=flocks
gremial=intimate=intimate
gressorial=adapted for walking=walking
grillage=framework of timber=timber
gripulous=grasping=grasping
grith=sanctuary=sanctuary
gromatics=science of surveying=surveying
grufted=dirty=dirty
grum=morose=morose
grumous=clotted=clotted
guarish=to heal=heal
guerdon=reward=reward
guff=nonsense=nonsense
gulosity=gluttony=gluttony
gummosity=gumminess=gumminess
gunarchy=government by women=women
gurgitate=to bubble=bubble
gurgitation=surging=surging
guttate=spotted=spotted
guttatim=drop by drop=drop
gymnophobia=fear of nudity=nudity
gynaecide=killing of women=women
gynaecocracy=government by women=women
gynandroid=hermaphroditic=hermaphroditic
gynarchy=government by women=women
gynics=knowledge of women=women
gynocracy=government by women=women
gyroidal=spiral=spiral
gyve=to fetter=fetter
habile=dexterous=dexterous
habiliment=attire=attire
haemal=pertaining to blood=blood
haematogenesis=production of blood=production
hagiology=study of saints=saints
hagiomania=mania for sainthood=sainthood
hakenkreuz=swastika=swastika
halcyonine=pertaining to kingfishers=kingfishers
halieutic=pertaining to fishing=fishing
halieutics=study of fishing=fishing
haligraphy=treatise on salt=treatise
halitous=vaporous=vaporous
halitus=vapour=vapour
hamartiology=study of sin=sin
hamate=hooked=hooked
hamose=hooked=hooked
hamshackle=to fetter=fetter
hapaxanthous=flowering only once=flowering
hardihood=boldness=boldness
hariolate=to divine=divine
harpagon=harpoon=harpoon
harry=to plunder=plunder
haussmannize=to open out=open
haut=high=high
hauteur=haughtiness=haughtiness
hawkshaw=detective=detective
headland=cape=cape
heartsome=exhilarating=exhilarating
hebetic=pertaining to puberty=puberty
hebetude=stupidity=stupidity
hederaceous=pertaining to ivy=ivy
helcoid=ulcerous=ulcerous
helcology=study of ulcers=ulcers
heliac=solar=solar
helictite=twisted=twisted
heliophobia=fear of sunlight=sunlight
helm=ship's steering wheel=ship
helminth=worm=worm
helminthiasis=infestation with worms=worms
helminthology=study of worms=worms
helotry=class of slaves=slaves
hematology=study of blood=blood
hemerology=calendar=calendar
hent=to grasp=grasp
hepatology=study of liver=liver
herbose=abounding with herbs=herbs
heresiology=study of heresies=heresies
hereticide=killing of heretics=killing
hérissé=bristled=bristled
heroarchy=government by heroes=heroes
herpetic=creeping=creeping
herpetoid=pertaining to snakes=snakes
herpetophobia=fear of snakes=snakes
herward=toward her=toward
hesternal=pertaining to yesterday=yesterday
hetaera=paramour=paramour
hetaerocracy=government by paramours=paramours
hetairism=concubinage=concubinage
heterism=variation=variation
heterotropic=squinting=squinting
hiant=gaping=gaping
hibber-gibber=gibberish=gibberish
hibernal=pertaining to winter=winter
hiemal=pertaining to winter=winter
hieratical=priestly=priestly
hight=named=named
hilasmic=propitiatory=propitiatory
himward=toward him=toward
hipped=melancholy=melancholy
hippic=pertaining to horses=horses
hippoid=equine=equine
hippomania=obsession with horses=obsession
hippophagy=feeding on horses=horses
hippophile=lover of horses=lover
hippophobe=hater of horses=horses
hircosity=goatishness=goatishness
hirsuties=hairiness=hairiness
hirudine=pertaining to leeches=leeches
hirudinean=pertaining to leeches=leeches
hirundine=pertaining to swallows=swallows
historiology=study of history=history
hither=to this place=place
hobbish=clownish=clownish
hobbledehoy=awkward=awkward
hobohemia=community of hoboes=hoboes
hogwash=nonsense=nonsense
holocryptic=inscrutable=inscrutable
homarine=pertaining to lobsters=lobsters
homichlophobia=fear of fog=fog
homiletical=pertaining to homilies=homilies
homiliary=book of sermons=sermons
homologate=to confirm=confirm
homoousia=identicality in substance=substance
homophobia=fear of homosexuals=homosexuals
honorificabilitudinity=honourableness=honourableness
hooey=nonsense=nonsense
horal=pertaining to hours=hours
hordeaceous=pertaining to barley=barley
hornwork=cuckoldry=cuckoldry
horologiography=description of timepieces=timepieces
horrent=bristling=bristling
hortensial=pertaining to gardens=gardens
hortulan=pertaining to gardens=gardens
hospitate=to greet=greet
hospitium=hospice=hospice
houghmagandy=fornication=fornication
housel=the eucharist=eucharist
howbeit=although=although
hoyden=tomboy=tomboy
hulchy=swollen=swollen
humect=to moisten=moisten
humectation=moisture=moisture
humify=to moisten=moisten
hyaloid=pertaining to glass=glass
hydatoid=watery=watery
hydrophobia=fear of water=water
hydropic=dropsical=dropsical
hyetal=rainy=rainy
hyetology=science of rainfall=rainfall
hygeian=pertaining to health=health
hygiology=hygienics=hygienics
hygrology=study of humidity=humidity
hygrometry=science of humidity=humidity
hylactic=barking=barking
hylarchic=ruling over matter=ruling
hyle=matter=matter
hylicism=materialism=materialism
hylobatine=pertaining to gibbons=gibbons
hymeneal=pertaining to marriage=marriage
hymnology=study of hymns=hymns
hypactic=purgative=purgative
hypaethral=roofless=roofless
hyperphagia=eating too much=much
hypnology=study of sleep=sleep
hypnomogia=insomnia=insomnia
hypodynamia=loss of strength=strength
hypogeal=underground=underground
hypometropia=shortsightedness=shortsightedness
hypostasis=basis=basis
hypostyle=pillar=pillar
hypothecary=pertaining to mortgages=mortgages
hypothecate=to mortgage=mortgage
hypotrichosis=hairlessness=hairlessness
hyrax=shrew=shrew
hysteroid=like  a womb=womb
hysteromania=nymphomania=nymphomania
hystricine=pertaining to porcupines=porcupines
iamatology=study of remedies=remedies
iambic=consisting of iambuses=iambuses
iatrarchy=government by physicians=physicians
ichneumous=parasitical=parasitical
ichnogram=footprint=footprint
ichthyic=pertaining to fish=fish
ichthyoid=fishlike=fishlike
ichthyology=study of fish=fish
ichthyonomy=classification of fishes=fishes
ickle=little=little
iconism=imagery=imagery
iconology=study of icons=icons
icteritious=jaundiced=jaundiced
ictuate=to emphasize=emphasize
idoneous=suitable=suitable
ifsoever=if ever=ever
ignavia=laziness=laziness
ignify=to burn=burn
ignipotent=presiding over fire=presiding
ignoscency=forgiveness=forgiveness
ilastical=propitiatory=propitiatory
ilicic=pertaining to holly=holly
illapse=to glide in=glide
illaqueate=to ensnare=ensnare
illaudable=not praiseworthy=praiseworthy
illecebrous=enticing=enticing
illude=to trick=trick
imbreviate=to enroll=enroll
immanation=flowing in=flowing
immanent=inherent=inherent
immarcescible=unfading=unfading
immerge=to immerse=immerse
immeritous=undeserving=undeserving
imminution=lessening=lessening
immission=insertion=insertion
immix=to commingle=commingle
immoralism=rejection of morality=rejection
immure=to imprison=imprison
impanate=embodied in bread=embodied
impavid=fearless=fearless
impedimenta=things that impede=things
impedimentary=hindering=hindering
impennate=featherless=featherless
imperscriptible=not recorded=recorded
impleach=to intertwine=intertwine
impletion=filling=filling
implex=not simple=simple
impostume=abscess=abscess
imprescriptible=inalienable=inalienable
imprimitive=not primitive=primitive
impudicity=shamelessness=shamelessness
impugn=to oppose=oppose
imsonic=onomatopoetic=onomatopoetic
inanition=emptiness=emptiness
inaurate=gilded=gilded
inbeing=inherence=inherence
incatenation=harnessing=harnessing
inchoate=undeveloped=undeveloped
incipient=beginning=beginning
incompossible=incapable of coexisting=incapable
inconscient=unconscious=unconscious
incontrair=in opposition to=opposition
incoronate=crowned=crowned
incorpse=to incorporate=incorporate
incrassate=to thicken=thicken
increscent=waxing=waxing
incubus=nightmare=nightmare
inculpate=to blame=blame
incult=uncultivated=uncultivated
indagate=to search out=search
indigence=poverty=poverty
indign=unworthy=unworthy
indite=to compose=compose
indue=to supply=supply
inescatory=pertaining to baiting=baiting
inesculent=inedible=inedible
ineunt=entering=entering
infandous=unmentionable=unmentionable
infaust=unlucky=unlucky
inficete=not facetious=facetious
infructuous=not fruitful=fruitful
infumate=smoky=smoky
ingannation=deception=deception
ingeminate=to reiterate=reiterate
ingerence=intrusion=intrusion
ingluvious=gluttonous=gluttonous
ingravescent=becoming more severe=severe
ingurgitate=to swallow=swallow
inhaust=to drink in=drink
inhere=be inherent=inherent
inhumation=burial=burial
inimical=hostile=hostile
iniquity=wickedness=wickedness
inlapidate=to petrify=petrify
inly=inwardly=inwardly
innominate=having no name=name
innoxious=harmless=harmless
inopinate=not thought of=thought
inquiline=living with another=living
inscenation=staging=staging
insectology=study of insects=insects
insessorial=adapted for perching=perching
insidiate=to conspire against=conspire
insipience=lack of wisdom=wisdom
insouciance=indifference=indifference
insouciant=lighthearted and unconcerned=unconcerned
instauration=restoration=restoration
intellection=act of thinking=thinking
intemerate=pure=pure
intempestive=unseasonable=unseasonable
intercalary=interpolated=interpolated
intercalation=interpolation=interpolation
interciliary=between the eyebrows=eyebrows
intercipient=intercepting=intercepting
interclude=to block=block
intercolline=lying between hills=lying
intercostal=between the ribs=ribs
interfenestration=spacing of windows=windows
interim=meanwhile=meanwhile
interjacent=intervening=intervening
interlocutor=one who converses=one
intermure=to wall in=wall
internecine=causing (mutual) destruction=mutual
interramification=interweaving of branches=interweaving
interscribe=to write between=write
intersidereal=between stars=stars
intervallum=between the ramparts=ramparts
intrant=entering=entering
intromit=to introduce=introduce
intumesce=to enlarge=enlarge
inusitation=disuse=disuse
inustion=burning in=burning
invaginate=to sheathe=sheathe
inveigle=to entice=entice
invenit=invented it=invented
inverecund=shameless=shameless
invictive=insurmountable=insurmountable
inwith=inside=inside
ipseity=selfhood=selfhood
ironice=ironically=ironically
irrased=in heraldry, indented=indented
irrefrangible=incapable of refraction=refraction
irregenerate=not regenerate=regenerate
irrelate=unrelated=unrelated
irremoval=absence of removal=removal
irrequisite=unnecessary=unnecessary
irresiant=having no residence=residence
irrespectuose=disrespectful=disrespectful
irresultive=having no result=result
irretiate=to ensnare=ensnare
irrevincible=invincible=invincible
irriguous=watered=watered
irrisible=worthy of derision=worthy
irrisory=mocking=mocking
irrite=void=void
irroborate=to strengthen=strengthen
isagogic=introductory=introductory
ischuretic=diuretic=diuretic
ischuria=retention of urine=urine
isography=imitation of handwriting=imitation
isopsephic=equal in number=number
issles=sparks=sparks
issuant=issuing from=issuing
isthmoid=resembling an isthmus=isthmus
item=likewise=likewise
iter=circuit=circuit
iterant=repeating=repeating
iteration=repetition=repetition
ithyphallic=indecent=indecent
itinerarian=traveller=traveller
iulus=millipede=millipede
ivresse=drunkenness=drunkenness
iwis=surely=surely
ixiodic=pertaining to ticks=ticks
jabberwock=nonsense, gibberish=nonsense
jactancy=boastfulness, vainglory=vainglory
jactation=throwing=throwing
jalouse=to suspect=suspect
jannock=outspoken=outspoken
jarta=term of endearment=term
jasper=to marble=marble
jasperated=mottled=mottled
jaunce=to prance=prance
jawhole=cesspool=cesspool
jaw-jaw=empty, sterile chatter=empty
jectigation=wagging, tremulous movement=wagging
jejunator=one who fasts=one
jemmy=burglar's short crowbar=burglar
jentacular=pertaining to breakfast=breakfast
jessant=in heraldry, overlying=overlying
jesuitical=cunning=cunning
jesuitocracy=government by Jesuits=jesuits
jigamaree=a thingamajig=thingamajig
jiggumbob=a thingamabob=thingamabob
jocko=a chimpanzee=chimpanzee
jocose=merry=merry
jocoserious=half in jest=jest
jordan=a chamberpot=chamberpot
joss=luck, fate=luck
jubate=maned=maned
jugate=side by side=side
juggins=a simpleton=simpleton
juglandaceous=pertaining to walnuts=walnuts
jumentous=like a horse=like
juncaceous=pertaining to rushes=rushes
juramentum=oath=oath
jurant=taking an oath=taking
jure=by law=law
jus=law=law
jussive=expressing a command=expressing
justiciar=administrator of justice=justice
juvenal=a youth=youth
kainotophobia=fear of change=change
kakorrhaphiophobia=fear of failure=failure
kalology=study of beauty=beauty
kamerad=to surrender=surrender
katabasis=going down=going
katzenjammer=hangover=hangover
kebbie=a shepherd's crook=shepherd
keck=to retch=retch
keffel=a horse=horse
keister=burglar's tool kit=burglar
kelter=nonsense=nonsense
kemb=to comb=comb
kennebecker=knapsack=knapsack
kerasine=horny=horny
kern=to granulate=granulate
ket=carrion=carrion
keybugle=bugle with keys=keys
kickie-wickie=a wife=wife
kickshaws=a trinket=trinket
kidder=a forestaller=forestaller
kidology=study of kidding=kidding
killcow=a bully=bully
kinchin=a child=child
kine=cows=cows
kinematics=study of motion=motion
kismet=fate=fate
kith=knowledge=knowledge
kleptocracy=government by thieves=thieves
klopemania=kleptomania=kleptomania
knackish=cunning=cunning
knag=knot in wood=wood
knarred=gnarled=gnarled
knout=to flog=flog
kohlrabi=variety of cabbage=variety
kritarchy=government by judges=judges
kumiss=fermented mare's milk=milk
labile=adaptable=adaptable
lability=plasticity=plasticity
labtebricole=living in holes=living
lacertilian=pertaining to lizards=lizards
lacis=network=network
laconicum=sauna=sauna
lacteous=milky=milky
lactifluous=flowing with milk=milk
lacuscular=pertaining to pools=pools
lacustrine=pertaining to lakes=lakes
ladronism=banditry=banditry
laetificate=to cheer up=cheer
lagena=flask=flask
lagniappe=gratuity=gratuity
lagostoma=harelip=harelip
lamiaceous=minty=minty
lamister=fugitive=fugitive
lampadephore=torchbearer=torchbearer
lampadomancy=divination by flame=flame
lanate=woolly=woolly
lancinate=to lacerate=lacerate
lancination=sharp=sharp
languor=listlessness=listlessness
lanuginose=downy=downy
Laodicean=lukewarm=lukewarm
lapactic=purgative=purgative
lapicide=stonecutter=stonecutter
lapidarian=pertaining to stones=stones
lapideous=stony=stony
lapifidication=petrifaction=petrifaction
lappaceous=prickly=prickly
lardaceous=pertaining to lard=lard
largifical=ample=ample
largiloquent=talkative=talkative
largition=giving of largess=largess
larine=pertaining to gulls=gulls
laroid=pertaining to gulls=gulls
larvicide=killing of larvae=larvae
larvivorous=feeding on larvae=larvae
laryngology=study of larynx=larynx
lasher=weir=weir
latebricole=living in holes=living
laterad=towards the side=towards
latitant=lurking=lurking
latrant=barking=barking
lautitious=sumptuous=sumptuous
lavic=pertaining to lava=lava
lazaretto=hospital for lepers=lepers
lecithal=having a yolk=yolk
lection=reading=reading
legerity=lightness=lightness
leguleian=like a lawyer=like
lemurine=pertaining to lemurs=lemurs
lenitive=soothing=soothing
lenity=mildness=mildness
lentigo=freckle=freckle
lentitude=lethargy=lethargy
lentor=sluggishness=sluggishness
lepadoid=resembling a barnacle=barnacle
lepid=pleasant=pleasant
lepidine=composed of scales=scales
lepidity=facetiousness=facetiousness
leprology=study of leprosy=leprosy
leprosarium=hospital for lepers=lepers
leprose=scaly=scaly
lethe=oblivion=oblivion
leucous=albino=albino
levigate=to smooth=smooth
levin=lightning=lightning
lexiphanic=bombastic=bombastic
liard=grey=grey
liberticide=destruction of liberty=liberty
libertinage=debauchery=debauchery
librate=to oscillate=oscillate
lichenography=description of lichens=lichens
lichenology=study of lichens=lichens
lickerish=lecherous=lecherous
lief=soon=soon
ligneous=woody=woody
ligniperdous=destructive of wood=wood
lignivorous=feeding on wood=wood
limacine=pertaining to slugs=slugs
limacology=study of slugs=slugs
limax=slug=slug
limbate=possessing a border=possessing
limbus=border=border
limes=border=border
limicolous=living in mud=mud
limner=painter of portraits=portraits
limous=muddy=muddy
limpid=clear=clear
linaceous=pertaining to flax=flax
linonophobia=fear of string=string
lipomatosis=obesity=obesity
lipothymy=swoon=swoon
lipsanotheca=container for relics=relics
liquate=to melt=melt
lissome=lithe=lithe
literatim=letter for letter=letter
literator=dabbler in learning=learning
lithoglyph=engraving on stone=stone
lithology=study of rocks=rocks
liturate=spotted=spotted
lixiviation=leaching=leaching
lochetic=waiting in ambush=waiting
loculate=having loculi=loculi
locutory=room for conversation=room
lodesman=pilot=pilot
logia=collection of sayings=sayings
logocracy=government of words=words
logodaedalus=artificer in words=words
loimic=pertaining to plagues=plagues
longanimity=forbearance=forbearance
longiniquity=remoteness=remoteness
loquence=speech=speech
lordolatry=worship of nobility=worship
lorette=courtesan=courtesan
lorgnon=an eyeglass=eyeglass
lorimer=saddlemaker=saddlemaker
lotophagous=feeding on lotuses=lotuses
louche=squinting=squinting
loxophthalmus=squint=squint
loxotic=distorted=distorted
lubricious=slippery=slippery
lubricity=greasiness=greasiness
lucent=shining=shining
lucernal=pertaining to lamps=lamps
lucriferous=lucrative=lucrative
lucripetous=eager for gain=gain
luctation=struggle=struggle
luculent=bright=bright
ludibry=contempt=contempt
ludibund=playful=playful
ludicrism=burlesque=burlesque
lugubrious=mournful=mournful
lumbricine=pertaining to earthworms=earthworms
lupine=pertaining to wolves=wolves
lupulic=pertaining to hops=hops
lusory=playful=playful
luteolous=yellowish=yellowish
lutescent=yellowish=yellowish
lutrine=pertaining to otters=otters
lutulent=thick=thick
luxuriant=overabundant in growth=overabundant
Lydian=effeminate=effeminate
lygophilia=love of darkness=darkness
lygophobia=fear of darkness=darkness
lysis=disintegration=disintegration
mabble=to wrap up=wrap
mabsoot=happy=happy
macarism=a beatitude=beatitude
macaroni=nonsense=nonsense
macies=atrophy=atrophy
macilent=lean=lean
macropicide=killer of kangaroos=killer
macropodine=pertaining to kangaroos=kangaroos
macrotone=macron=macron
macular=spotted=spotted
maculose=spotted=spotted
madid=wet=wet
maenadic=furious=furious
magirics=art of cookery=cookery
magnetics=study of magnetism=magnetism
magpiety=garrulousness=garrulousness
maieutics=midwifery=midwifery
malacology=study of molluscs=molluscs
malacophilous=pollinated by snails=snails
malapert=bold=bold
malariology=study of malaria=malaria
malarkey=humbug=humbug
maledicent=cursing=cursing
malefic=doing mischief=mischief
malgrado=notwithstanding=notwithstanding
malgré=in spite of=spite
maliferous=harmful=harmful
malison=a curse=curse
malleation=hammering=hammering
malversation=corruption in office=office
mammalogy=study of mammals=mammals
mammer=to stammer=stammer
mammetry=idolatry=idolatry
mammiferous=having breasts=breasts
mammila=nipple=nipple
mammon=riches=riches
mandament=command=command
mansionary=residence=residence
mansuetude=meekness=meekness
mansworn=perjured=perjured
mantic=pertaining to divination=divination
manumission=emancipation=emancipation
manurance=cultivation=cultivation
manustupration=masturbation=masturbation
marah=bitterness=bitterness
marc=refuse from winemaking=winemaking
maremma=marsh=marsh
martyrology=study of martyrs=martyrs
masticate=to chew=chew
mastigophorous=bearing a whip=whip
mastology=study of mammals=mammals
materteral=of  an aunt=aunt
mathemancy=divination by counting=divination
mattery=purulent=purulent
maugre=in spite of=spite
maunder=to grumble=grumble
maya=illusion=illusion
mayhap=perhaps=perhaps
mazology=mammalogy=mammalogy
mazy=dizzy=dizzy
mechanolatry=worship of machines=worship
medicaster=quack=quack
meditabund=absorbed in meditation=meditation
medusiform=resembling a jellyfish=jellyfish
meedless=undeserving=undeserving
meet=fitting=fitting
megrim=dizziness=dizziness
mel=honey=honey
melanic=black=black
meleagrine=pertaining to turkeys=turkeys
melic=to be sung=sung
melisma=tune=tune
melismatic=florid in melody=melody
melittology=study of bees=bees
mellaginous=pertaining to  honey=honey
melomania=craze for music=music
melopoeia=composition of music=music
memoriter=from memory=memory
memoriter=from memory=memory
menald=speckled=speckled
mendacity=insincerity=insincerity
mentatiferous=telepathic=telepathic
mentation=thought=thought
mentum=the chin=chin
meracious=pure=pure
mercurial=volatile=volatile
meretricious=pertaining to prostitution=prostitution
merogenesis=segmentation=segmentation
meromorphic=fractional=fractional
mersion=dipping=dipping
merycism=rumination=rumination
mesial=middle=middle
mesology=ecology=ecology
mesquin=mean=mean
metabasis=transition=transition
metagnomy=divination=divination
metagnostic=incomprehensible=incomprehensible
metagraphy=transliteration=transliteration
metagrobolize=to mystify=mystify
metanoia=repentance=repentance
metaphony=umlaut=umlaut
metaphysis=change in form=form
metheglin=mead=mead
methinks=I believe=believe
methysis=drunkenness=drunkenness
metrics=study of versification=versification
metrophobia=fear of poetry=poetry
mignon=small and dainty=small
millesimal=thousandth=thousandth
milliad=millennium=millennium
millionocracy=government by millionaires=millionaires
milquetoast=very timid=timid
mim=prim, demure=prim
mimature=mimicry=mimicry
mimetic=imitative=imitative
minacious=threatening=threatening
minatory=threatening=threatening
minauderie=display of affectation=display
mineralogy=study of minerals=minerals
minimuscular=tiny=tiny
minium=vermilion=vermilion
mirabilia=wonders=wonders
mird=to meddle=meddle
misacceptation=misinterpretation=misinterpretation
misandry=hatred of men=men
miscellanarian=writer of miscellanies=writer
misoneism=hatred of novelty=novelty
misopaedia=hatred of children=hatred
misprise=to scorn=scorn
misprision=mistake=mistake
mithridate=antidote to poison=poison
mixen=dunghill=dunghill
mizmaze=labyrinth=labyrinth
mnesic=pertaining to memory=memory
modena=crimson=crimson
modish=fashionable=fashionable
modulo=taking into account=taking
mofussil=provincial=provincial
moilsome=laborious=laborious
moirologist=mourner for hire=mourner
molendinary=mill=mill
mollescent=softening=softening
mollipilose=downy=downy
mollities=softness=softness
mollitious=luxurious=luxurious
molluscicide=killing of mollusks=mollusks
molochize=to sacrifice=sacrifice
momentaneous=momentary=momentary
momilogy=study of mummies=mummies
Momus=satirist=satirist
monachism=monasticism=monasticism
mondain=worldly=worldly
monial=a nun=nun
monition=caution=caution
monkery=monks in general=monks
monochronic=contemporaneous=contemporaneous
monothelious=polyandrous=polyandrous
monotroch=wheelbarrow=wheelbarrow
montane=mountainous=mountainous
montero=huntsman=huntsman
moot=meeting=meeting
mora=delay=delay
morbilli=measles=measles
morbus=disease=disease
mordacious=given to biting=given
mordant=biting=biting
morgue=haughtiness=haughtiness
moria=folly=folly
morient=dying=dying
morne=dismal=dismal
morology=nonsense=nonsense
morphean=pertaining to dreams=dreams
morse=walrus=walrus
morsure=a bite=bite
mouldwarp=mole=mole
mountenance=amount=amount
movent=moving=moving
moyenant=by means of=means
mucago=mucus=mucus
mucedinous=mouldy=mouldy
mucid=mouldy=mouldy
mucorrhoea=discharge of mucus=mucus
mugient=bellowing=bellowing
mulciberian=pertaining to metalworking=metalworking
mulct=to swindle=swindle
muliebrile=womanly=womanly
muliebrity=womanhood=womanhood
mulley=hornless=hornless
mullock=nonsense=nonsense
multeity=manifoldness=manifoldness
multiloquence=talkativeness=talkativeness
mundify=to cleanse=cleanse
munify=to fortify=fortify
muniment=means of defence=means
muriated=pickled=pickled
muriatic=briny=briny
muriphobia=fear of mice=mice
muscoid=pertaining to mosses=mosses
musomania=obsession with music=obsession
mussitate=to mutter=mutter
mussitation=murmuring=murmuring
mutivity=tendency to alter=tendency
mycology=study of funguses=funguses
mycterism=sneering=sneering
myology=study of muscles=muscles
myophobia=fear of mice=mice
myoxine=pertaining to dormice=dormice
myringa=eardrum=eardrum
myrmecoid=antlike=antlike
myrmecology=study of ants=ants
myrmecophagid=pertaining to anteaters=anteaters
myrmecophagous=feeding on ants=feeding
myrmicine=pertaining to ants=ants
myrmidon=follower=follower
mythoclast=destroyer of myths=myths
mythogenesis=origin of myths=origin
nabalism=churlishness=churlishness
nabalitic=churlish=churlish
nacket=snack=snack
naevous=spotted=spotted
naevus=birthmark=birthmark
naos=temple=temple
napoo=to destroy=destroy
nares=the nostrils=nostrils
narquois=mocking=mocking
narrischkeit=foolishness=foolishness
nary=not a one=one
nascent=immature=immature
naskin=prison=prison
natable=able to float=float
natation=swimming=swimming
nates=the buttocks=buttocks
natheless=nevertheless=nevertheless
naucify=to despise=despise
nautics=art of navigation=navigation
nearabout=nearby=nearby
nearhand=nearly=nearly
neatherd=cowherd=cowherd
nebbich=colourless=colourless
nebulaphobia=fear of fog=fog
necessitudinarian=determinist=determinist
necrobiosis=death of cells=death
necrologue=obituary=obituary
necrophobia=fear of corpses=corpses
necrotomy=dissection=dissection
nectarivorous=feeding on nectar=nectar
needs=of necessity=necessity
nefandous=abominable=abominable
nefastous=wretched=wretched
negrophobia=fear of blacks=blacks
nemorivagant=wandering through forests=wandering
nemorous=wooded=wooded
neogamist=newlywed=newlywed
neolagnium=puberty=puberty
neolatry=worship of novelty=worship
neophobia=fear of novelty=novelty
neophrastic=pertaining to neologisms=neologisms
nephelognosy=observation of clouds=observation
nepheloid=cloudy=cloudy
nephogram=photograph of clouds=photograph
nephology=study of clouds=clouds
nervine=quieting=quieting
nescience=lack of knowledge=lack
nesh=soft=soft
nettlesome=irritable=irritable
neuroid=like a nerve=nerve
neurypnology=study of hypnotism=hypnotism
nevus=birthmark=birthmark
nexility=compactness of speech=speech
nexus=a bond=bond
niaiserie=simplicity=simplicity
niccolic=pertaining to nickel=nickel
nicotian=pertaining to tobacco=tobacco
nidatory=pertaining to nests=nests
nidology=study of nests=nests
nigh=nearly=nearly
nigrescence=blackness=blackness
nigrine=black=black
nigroglobulate=to blackball=blackball
nihility=nothingness=nothingness
nil=nothing=nothing
nill=to refuse=refuse
nim=to steal=steal
nimbose=cloudy=cloudy
nimiety=excess=excess
nisus=effort=effort
nitency=brightness=brightness
nitency=effort=effort
nitid=bright=bright
niveous=snowy=snowy
nobbut=except=except
nobiliary=pertaining to nobility=nobility
nobilitate=to ennoble=ennoble
nocent=hurtful=hurtful
nociceptive=sensitive to pain=sensitive
noctiflorous=flowering at night=night
noctilucent=phosphorescent=phosphorescent
nocuous=hurtful=hurtful
nodality=knottedness=knottedness
nodated=knotted=knotted
noddypeak=fool=fool
nodosity=knottiness=knottiness
noegenesis=production of knowledge=production
nomenclator=lexicon=lexicon
nomic=customary=customary
nominatim=by name=name
nonobstant=notwithstanding=notwithstanding
nosocomium=hospital=hospital
nosography=description of diseases=diseases
nosology=study of diseases=diseases
nosophobia=fear of disease=disease
nostology=study of senility=senility
nothous=spurious=spurious
novity=innovation=innovation
noyade=execution by drowning=execution
nubecula=a cloudiness=cloudiness
nubiform=cloudlike=cloudlike
nubilate=to obscure=obscure
nubilous=cloudy=cloudy
nucal=pertaining to nuts=nuts
nucule=a nutlet=nutlet
nugacious=unimportant=unimportant
nugament=nonsense=nonsense
nugatory=inconsequential=inconsequential
nullifidian=having no faith=faith
numismatics=study of coins=coins
nuncius=messenger=messenger
nuncle=to defraud=defraud
nuncupative=oral=oral
nundination=trading=trading
nupson=simpleton=simpleton
nutant=nodding=nodding
nutrication=nourishment=nourishment
nutrice=nurse=nurse
nutricial=pertaining to nurses=nurses
nyctanthous=flowering at night=night
nymphology=study of nymphs=nymphs
oakus=wallet=wallet
obambulate=to wander about=wander
obduracy=stubbornness=stubbornness
obedible=docile=docile
obeliscolychny=lighthouse=lighthouse
obequitate=to ride about=ride
obfuscate=to obscure=obscure
obiter=in passing=passing
obitual=pertaining to obituaries=obituaries
objicient=objector=objector
objurgate=to chide=chide
oblation=act of offering=offering
oblectation=enjoyment=enjoyment
obliquation=obliqueness=obliqueness
oblivescence=forgetfulness=forgetfulness
obloquy=censure=censure
obluctation=resistance=resistance
obmutescent=speechless=speechless
obnixely=earnestly=earnestly
obnubilate=to becloud=becloud
obsecrate=to beseech=beseech
obsequies=funeral=funeral
obstetrics=study of midwifery=midwifery
obstreperous=noisy=noisy
obstriction=obligation=obligation
obtundent=dulling=dulling
obturate=to stop up=stop
obumbrate=to overshadow=overshadow
obvallate=walled in=walled
obvert=to turn=turn
obvolute=overlapping=overlapping
obvolvent=enwrapping=enwrapping
ocellated=eyelike and ringed=ringed
ochlocracy=government by mobs=mobs
ochlophobia=fear of crowds=crowds
ocracy=government=government
octarius=pint=pint
octodont=degu=degu
octothorp=hash=hash
oculate=having eyes=eyes
odible=worthy of hatred=worthy
odium=hatred=hatred
odograph=odometer=odometer
odontalgia=toothache=toothache
odontist=dentist=dentist
odontology=study of teeth=teeth
odophone=scale of odours=scale
oecodomic=pertaining to architecture=architecture
oeillade=an ogle=ogle
oenology=study of wines=wines
ogdoad=set of eight=set
oikology=science of housekeeping=housekeeping
olent=having a smell=smell
olim=formerly=formerly
olio=miscellany=miscellany
ombré=shadowy=shadowy
ombrology=study of rain=rain
ombrophobia=fear of rain=rain
omnifarious=of all kinds=kinds
omnigenous=of all kinds=kinds
omphalism=centralization in government=government
omphalos=the navel=navel
onanism=masturbation=masturbation
oncology=study of tumours=tumours
ondoyant=wavy=wavy
oneiric=pertaining to dreams=dreams
oneirodynia=nightmare=nightmare
oneirology=study of dreams=dreams
oneiromancy=divination by dreams=dreams
oniscoid=like a woodlouse=woodlouse
onomamania=mania for names=names
onomasiology=study of nomenclature=nomenclature
onychoid=like a fingernail=like
onymatic=pertaining to names=names
oology=study of eggs=eggs
oophoron=ovary=ovary
operose=laborious=laborious
ophic=pertaining to serpents=serpents
ophidiophobia=fear of snakes=snakes
ophiolatry=worship of snakes=worship
ophiology=study of snakes=snakes
ophiomormous=snakelike=snakelike
opificer=artificer=artificer
opiomania=craving for opium=opium
opisthosomal=pertaining to posteriors=posteriors
oppidan=urban=urban
oppignorate=to pawn=pawn
oppilate=to block up=block
opprobrium=disgrace=disgrace
optics=study of light=light
optology=study of sight=sight
orad=toward the mouth=toward
orad=towards the mouth=towards
oragious=stormy=stormy
orarian=coastal=coastal
orarium=handkerchief=handkerchief
orbific=creating the world=world
orchidology=study of orchids=orchids
ordinant=one who ordains=ordains
orfèvrerie=goldsmith's work=work
organon=method of investigation=method
orgulous=proud=proud
orison=prayer=prayer
ornithic=pertaining to birds=birds
ornithology=study of birds=birds
ornithon=aviary=aviary
ornithophilous=pollinated by birds=pollinated
ornithophobia=fear of birds=birds
orography=description of mountains=mountains
orology=study of mountains=mountains
ort=scrap of food=scrap
orthography=study of spelling=spelling
orthopter=ornithopter=ornithopter
orthopterology=study of cockroaches=cockroaches
oryctognosy=mineralogy=mineralogy
oryctography=description of minerals=minerals
oscitancy=yawning=yawning
oscitate=to yawn=yawn
osculate=to kiss=kiss
osmesis=act of smelling=smelling
osphresis=sense of smell=smell
ossia=alternatively=alternatively
ossifrage=osprey=osprey
ossivorous=feeding on bones=feeding
ostent=appearance=appearance
osteography=description of bones=description
osteoid=bony=bony
osteology=study of bones=bones
ostiary=doorkeeper=doorkeeper
ostiolate=having an opening=opening
ostracean=pertaining to oysters=oysters
ostraceous=pertaining to oysters=oysters
otalgia=earache=earache
otarine=pertaining to seals=seals
otiose=superfluous=superfluous
otosis=mishearing of speech=speech
oundy=wavy=wavy
outcept=excluding=excluding
outjet=projection=projection
outroop=auction=auction
outwith=outside of=outside
ouzel=blackbird=blackbird
ovarious=consisting of eggs=eggs
overcross=across=across
overflush=superfluity=superfluity
overhaile=to overtake=overtake
overrack=to overstrain=overstrain
overset=to upset=upset
oviform=like a sheep=sheep
ovine=pertaining to sheep=sheep
pabouche=a slipper=slipper
pabulous=pertaining to nourishment=nourishment
pabulum=food=food
pachydermia=elephantiasis=elephantiasis
pachynsis=thickening=thickening
padrone=innkeeper=innkeeper
paean=song of thanksgiving=thanksgiving
paedarchy=government by children=government
paedocracy=government by children=government
paedology=study of children=children
paedophage=eater of children=eater
paedophobia=fear of children=children
paillette=a spangle=spangle
paizogony=necking=necking
palabra=a word=word
palaeophile=antiquarian=antiquarian
paleaceous=chaffy=chaffy
palfrenier=groom=groom
pallasethesia=sense of vibration=vibration
pallid=pale=pale
palmary=principal=principal
palpebration=winking=winking
paludal=pertaining to marshes=marshes
paludicolous=growing in marshes=marshes
paludose=marshy=marshy
palynology=study of pollen=pollen
pampiniform=like a tendril=tendril
panaceist=believer in panaceas=panaceas
panaesthesia=totality of perception=totality
panary=pertaining to bread=bread
panatella=long=long
panchreston=panacea=panacea
pancyclopaedic=encyclopaedic=encyclopaedic
pandation=warping=warping
pandemian=vulgar=vulgar
pandemic=universal=universal
panegoism=solipsism=solipsism
panification=conversion into bread=conversion
pantophagy=omnivorousness=omnivorousness
pantophobia=fear of everything=everything
papaverous=pertaining to poppies=poppies
papilionaceous=pertaining to butterflies=butterflies
papule=pimple=pimple
papuliferous=pimply=pimply
papyrology=study of paper=paper
parabolist=teller of parables=teller
paracme=decline=decline
paradromic=adjacent=adjacent
paragnosia=misunderstanding=misunderstanding
paragraphy=writing of paragraphs=paragraphs
paramnesia=abnormality of memory=memory
paranym=euphemism=euphemism
paraphrast=one who paraphrases=paraphrases
parapraxis=blunder=blunder
pararthria=incoherence=incoherence
parasiticide=killing of parasites=parasites
parathesis=apposition=apposition
paravail=inferior=inferior
paravant=in front=front
parbreak=to vomit=vomit
parcel=partly=partly
pardine=pertaining to leopards=leopards
paregoric=soothing=soothing
parentelic=related by blood=related
pareunia=coitus=coitus
parfay=by my faith=faith
parget=to plaster over=plaster
pari passu=side by side=side
parine=pertaining to titmouses=titmouses
paristhimion=tonsil=tonsil
Parnassian=poetic=poetic
parochial=local=local
paroemiographer=writer of proverbs=writer
paroemiography=writing of proverbs=proverbs
paroemiology=study of proverbs=proverbs
paromoeon=alliteration=alliteration
paronomasia=play on words=words
paroxysm=fit of passion=passion
parsonarchy=government by parsons=parsons
parthenian=pertaining to virgins=virgins
parthenology=study of virgins=virgins
parthophobia=fear of virgins=virgins
partim=in part=part
parvanimity=smallness of mind=smallness
pasquilant=lampooner=lampooner
pasquin=to lampoon=lampoon
pasquinade=to lampoon=lampoon
pasquinian=satirical=satirical
passerine=pertaining to sparrows=sparrows
passim=everywhere=everywhere
pastance=pastime=pastime
patation=act of drinking=drinking
patavinity=provincialism=provincialism
patefaction=disclosure=disclosure
paten=plate=plate
pathic=passive=passive
pathophobia=fear of disease=disease
patulous=spreading=spreading
pauciloquent=of few words=words
pavid=timid=timid
pavonian=pertaining to peacocks=peacocks
pavonine=pertaining to peacocks=peacocks
paynimry=heathendom=heathendom
paysage=landscape=landscape
paysagist=painter of landscapes=painter
peccable=liable to sin=sin
peccaminous=sinful=sinful
peccancy=sinfulness=sinfulness
pecorous=full of cows=full
pectinal=of a comb=comb
pectize=to congeal=congeal
pectuncle=cockle=cockle
pecudiculture=rearing of cattle=rearing
peculation=embezzlement=embezzlement
pecuniary=pertaining to money=money
pedagogics=study of teaching=teaching
pedagoguery=schoolmastering=schoolmastering
pedaneous=going on foot=going
pedate=footed=footed
pedicular=pertaining to lice=lice
pediculicide=killing of lice=lice
pediculophobia=fear of lice=lice
pediculous=lousy=lousy
pedological=pertaining to soils=soils
pedology=study of soils=soils
peirastic=experimental=experimental
peise=weight=weight
pejorate=to worsen=worsen
pelagic=oceanic=oceanic
pelargic=pertaining to storks=storks
pelasgic=nomadic=nomadic
pelerine=woman's fur cape=woman
pellate=to divide=divide
pelma=sole of foot=sole
pelmatogram=footprint=footprint
pelology=study of mud=mud
peltiferous=bearing a shield=shield
pelurious=furry=furry
pendent=hanging=hanging
pennaceous=featherlike=featherlike
pennate=winged=winged
pensile=hanging=hanging
pensum=task=task
penury=destitution=destitution
peradventure=perhaps=perhaps
percipient=perceiving=perceiving
perdicine=pertaining to partridges=partridges
perdricide=killer of partridges=partridges
perduellion=treason=treason
peregrinity=foreignness=foreignness
perfervid=very fervid=fervid
perficient=effectual=effectual
peribolos=precinct=precinct
periclitate=to endanger=endanger
periculous=dangerous=dangerous
periodontics=study of gums=gums
periotic=around the ear=ear
peripatetic=wandering about=wandering
periphrasis=circumlocution=circumlocution
perissology=verbiage=verbiage
peristeronic=pertaining to pigeons=pigeons
perlaceous=pearly=pearly
pernicious=destructive=destructive
peroral=through the mouth=mouth
perruquier=wigmaker=wigmaker
persiflage=banter=banter
perstringe=to constrain=constrain
pertuse=punched=punched
perulate=scaly=scaly
pervicacious=very obstinate=obstinate
pervious=permeable=permeable
pestology=science of pests=pests
petrology=study of rocks=rocks
petrous=stony=stony
phacochoerine=pertaining to warthogs=warthogs
phaeic=dusky=dusky
phaeism=duskiness=duskiness
phagophobia=fear of eating=eating
phalacrosis=baldness=baldness
phallephoric=carrying the penis=penis
phallocracy=government by men=men
phanic=visible=visible
pharisaic=hypocritical=hypocritical
pharmacology=study of drugs=drugs
pharology=study of lighthouses=lighthouses
phellem=cork=cork
phemic=pertaining to speech=speech
phengophobia=fear of daylight=daylight
phenomenology=study of phenomena=phenomena
phialine=resembling a phial=phial
philalethist=lover of truth=truth
philistine=materialistic in outlook=outlook
philocaly=love of beauty=beauty
philogyny=love of women=women
philomath=lover of learning=lover
philomelian=pertaining to nightingales=nightingales
philopornist=lover of prostitutes=prostitutes
philosophocracy=government by philosophers=philosophers
philotherianism=love of animals=animals
philoxenia=hospitality=hospitality
phlegmatic=of a calm=calm
phocine=pertaining to seals=seals
phoenicopter=flamingo=flamingo
phonasthenia=weakness of voice=weakness
phossy=caused by phosphorus=phosphorus
photaesthesia=sense of vision=vision
photophobia=fear of light=light
phototonus=sensitivity to light=sensitivity
phraseology=study of phrases=phrases
phrenesis=delirium=delirium
phthartic=deadly=deadly
phylactic=defending against disease=disease
phyllophorous=leafy=leafy
phytivorous=feeding on plants=plants
phytogenic=derived from plants=plants
phytology=study of plants=plants
phytophilous=fond of plants=plants
phytosophy=knowledge of plants=plants
piacular=expiatory=expiatory
picine=pertaining to woodpeckers=woodpeckers
picksome=particular=particular
pickthank=sycophant=sycophant
piddle=nonsense=nonsense
pied=variegated=variegated
pight=to pitch=pitch
pigsconce=blockhead=blockhead
pigwash=rubbish=rubbish
pinguid=fat=fat
pinion=wing=wing
piscatology=study of fishes=fishes
piscicapturist=fisherman=fisherman
piscine=pertaining to fish=fish
pismire=an ant=ant
pixilated=bemused=bemused
placentigerous=bearing a placenta=placenta
plagiary=one who plagiarises=plagiarises
planetic=erring=erring
planetology=study of planets=planets
plangency=resonance=resonance
plangorous=mournful=mournful
planipennate=having flat=flat
planish=to polish=polish
planography=cartography=cartography
plash=dash of water=water
plataleiform=spoonbilled=spoonbilled
pleasance=pleasure=pleasure
plenary=full=full
plenitude=fullness=fullness
pleonasm=redundancy=redundancy
pleonectic=greedy=greedy
pleonexia=greed=greed
pleroma=fullness=fullness
plexure=network=network
plexus=network=network
plumassier=worker in feathers=worker
plumbago=graphite=graphite
plumbeous=leaden=leaden
plumigerous=plumaged=plumaged
plumulate=downy=downy
plutolatry=worship of wealth=worship
plutomania=mania for money=money
plutonomy=economics=economics
pluviose=rainy=rainy
pneumatomorphic=like a spirit=spirit
poaceous=pertaining to grass=grass
pococurante=uninterested=uninterested
poculent=fit for drinking=fit
podagra=gout=gout
podagrous=gouty=gouty
podalic=pertaining to feet=feet
podex=rump=rump
poecilonym=synonym=synonym
poetolatry=worship of poets=worship
pogonophobia=fear of beards=beards
pogonotomy=shaving=shaving
poiesis=creation=creation
poikilitic=mottled=mottled
poimenic=pastoral=pastoral
polemology=study of war=war
polemomania=mania for war=war
policeocracy=government by police=police
politicomania=mania for politics=politics
pollent=strong=strong
pollex=the thumb=thumb
pollicitation=promise=promise
poltroon=craven=craven
polyaemia=plethora=plethora
polyphiloprogenitive=very fertile=fertile
polyphloisboisterous=noisy=noisy
polypragmatist=busybody=busybody
polysarcous=obese=obese
pomander=ball of perfumes=perfumes
pomiculture=growing of fruit=growing
ponent=western=western
pontlevis=drawbridge=drawbridge
popocracy=government by populists=populists
poppycock=humbug=humbug
poral=pertaining to pores=pores
porcine=pertaining to pigs=pigs
poriferous=having pores=pores
pornerastic=lecherous=lecherous
pornocracy=government by harlots=harlots
pornolagnia=desire for prostitutes=prostitutes
pornomania=obsession with pornography=pornography
porphyrous=purple=purple
portatile=portable=portable
portreeve=mayor=mayor
posh=nonsense=nonsense
postament=frame=frame
postcenal=after dinner=dinner
postcibal=after a meal=meal
postconnubial=after marriage=marriage
postexilic=after exile=exile
posticous=posterior=posterior
postjacent=posterior=posterior
postliminary=subsequent=subsequent
postprandial=after dinner=dinner
postreme=lastly=lastly
potable=fit to drink=fit
potamic=pertaining to rivers=rivers
potamology=study of rivers=rivers
poulp=octopus=octopus
pourboire=tip=tip
practive=practical=practical
prandial=pertaining to dinner=dinner
pratal=growing in meadows=meadows
pravity=wickedness=wickedness
preadamic=before Adam=adam
preallable=previous=previous
precantation=prophecy=prophecy
precative=supplicating=supplicating
precissive=separating=separating
preconize=to proclaim=proclaim
predacious=living by prey=prey
predella=platform for altar=platform
predevote=foreordained=foreordained
predicant=preaching=preaching
predicative=indicating the predicate=predicate
pregustation=foretaste=foretaste
prelation=preferment=preferment
prelect=to lecture=lecture
prelibation=foretaste=foretaste
prepense=premeditated=premeditated
prepollence=predominance=predominance
prerupt=broken off=broken
prescind=to cut off=cut
prescious=prescient=prescient
presentient=prescient=prescient
presidial=presidential=presidential
prest=to loan=loan
prestigiator=conjurer=conjurer
prestriction=blindness=blindness
pretermit=to pass by=pass
prevenient=antecedent=antecedent
prevision=foresight=foresight
prevoyant=having foresight=foresight
pridian=pertaining to yesterday=yesterday
primatology=study of primates=primates
princeps=first=first
priscan=ancient=ancient
privity=privacy=privacy
pro=in favour of=favour
pro rata=proportionally=proportionally
pro tanto=to that extent=extent
procacity=petulance=petulance
proceleusmatic=inciting=inciting
procellous=stormy=stormy
procerity=tallness=tallness
procidence=prolapse=prolapse
procinct=preparedness=preparedness
proclivitous=steep=steep
procoelous=cupped in front=front
proctology=study of rectum=rectum
procyonine=pertaining to raccoons=raccoons
proditor=traitor=traitor
proeguminal=predisposing=predisposing
proem=preface=preface
proemial=introductory=introductory
profligate=debauched=debauched
profluent=exuberant=exuberant
profulgent=shining out=shining
prolation=utterance=utterance
prolepsis=anticipation=anticipation
proleptical=prehistoric=prehistoric
proleptics=prognosis=prognosis
prolicide=killing of offspring=offspring
prolocutor=spokesman=spokesman
promptuary=repository=repository
prooemium=preface=preface
propinquity=closeness=closeness
propugnation=defence=defence
prore=prow=prow
prorrhesis=preface=preface
proseuche=place of prayer=prayer
prosilient=outstanding=outstanding
prosodemic=contagious=contagious
prosodic=pertaining to versification=versification
prosody=study of versification=versification
prosopopoeia=personification=personification
prosy=prosaic=prosaic
protactic=prefatory=prefatory
protean=variable=variable
protension=duration=duration
protervity=peevishness=peevishness
protistology=study of protists=protists
protogenist=inventor=inventor
protomorphic=primordial=primordial
protreptic=exhorting=exhorting
provand=allowance of food=food
provenance=source=source
providore=steward=steward
proxenete=procurer=procurer
psalmodist=singer of psalms=singer
psammous=sandy=sandy
psephitic=pertaining to pebbles=pebbles
pseudepigrapha=apocrypha=apocrypha
pseudochronism=error in dating=error
pseudolalia=incoherence of speech=speech
pseudosophy=pretension to wisdom=wisdom
psilosis=loss of hair=loss
psittacistically=mechanically=mechanically
psychagogic=attractive=attractive
pteridology=study of ferns=ferns
pteridomania=passion for ferns=passion
pterygoid=like a wing=wing
ptochogony=production of beggars=production
pubigerous=hairy=hairy
pucelage=virginity=virginity
pucelle=maid=maid
puckery=astringent=astringent
pudibund=shamefaced=shamefaced
pudicity=modesty=modesty
pudor=sense of shame=shame
puerperal=pertaining to childbirth=childbirth
puisne=inferior in rank=rank
puissant=powerful=powerful
pulchritude=beauty=beauty
pule=to pipe=pipe
pulicine=pertaining to fleas=fleas
pulicoid=like a flea=like
pullastrine=pertaining to pigeons=pigeons
pullulate=to swarm=swarm
pultaceous=macerated and softened=softened
punctal=like a point=point
punctate=dotted=dotted
punctatim=point for point=point
punctilious=scrupulous and exact=scrupulous
pundigrion=play on words=words
pundonor=point of honour=point
pupigerous=bearing a puparium=puparium
purloin=to steal=steal
purpureal=purple=purple
putanism=lewdness in women=women
putative=supposed=supposed
putid=decayed=decayed
putrefaction=rotting=rotting
pycnomorphous=compact=compact
pycnosis=thickening=thickening
pygmachy=boxing=boxing
pyoid=purulent=purulent
pyretology=study of fevers=fevers
pyrexia=fever=fever
pyrexical=feverish=feverish
pyrgology=study of towers=towers
pyroballogy=study of artillery=artillery
pyrogenation=subjection to heat=subjection
pyrography=study of woodburning=woodburning
pyrophobia=fear of fire=fire
pyrosis=heartburn=heartburn
pyrrhous=reddish=reddish
pyrrhuline=pertaining to bullfinches=bullfinches
pysmatic=questioning=questioning
pythogenic=produced by filth=produced
quab=to throb=throb
quackle=to choke=choke
quadragesimal=pertaining to Lent=lent
quadrifid=split into four=split
quadrobulary=fourfold=fourfold
quain=angle=angle
quaresimal=Lenten=lenten
quarion=candle=candle
quarred=soured=soured
quarrenden=variety of apple=variety
quat=a pimple=pimple
quatch=a word=word
quatern=arranged in fours=fours
quaternity=fourness=fourness
quatsch=nonsense=nonsense
queach=a thicket=thicket
queenite=a queen's partisan=queen
quelch=to squelch=squelch
querimonious=full of complaints=full
querimony=complaint=complaint
querist=inquirer=inquirer
querken=to stifle=stifle
querl=to twist=twist
querulist=one who complains=one
querulous=complaining=complaining
quesited=sought for=sought
queyock=heifer=heifer
quich=to stir=stir
quickhatch=wolverine=wolverine
quidditative=quirky=quirky
quidnunc=busybody=busybody
quietus=discharge from life=life
quiety=silence=silence
quinch=to wince=wince
quinnet=wedge=wedge
quinology=study of quinine=quinine
quinsell=horse's rein=rein
quirister=a chorister=chorister
quiritation=complaining=complaining
quisby=an idler=idler
quisle=to betray=betray
quisquilious=made of rubbish=rubbish
quisquous=perplexing=perplexing
quitter=pus=pus
quizzacious=satirical=satirical
quoad=with respect to=respect
quob =to throb=throb
quod=prison=prison
quodlibetificate=to quibble with=quibble
quoin=a wedge=wedge
quondam=former=former
quop=to writhe=writhe
quotannal=annual=annual
quotatious=tending to quote=tending
quotennial=yearly=yearly
quotidian=everyday=everyday
quotiety=number=number
quotity=proportion=proportion
quotuple=what multiple=multiple
rabic=pertaining to rabies=rabies
rabulous=scurrilous=scurrilous
raconteur=teller of anecdotes=teller
radicated=rooted=rooted
radiciform=like a root=root
radicolous=living on roots=roots
radix=root=root
radular=coarse=coarse
raffish=disreputable=disreputable
ragmatical=wild=wild
ramate=branched=branched
rameal=pertaining to branches=branches
ramiform=branching=branching
rampallion=scoundrel=scoundrel
ramus=branch of anything=branch
ranarian=froggy=froggy
rand=border=border
randan=uproar=uproar
rantipole=wild=wild
ranunculaceous=pertaining to buttercups=buttercups
raptorial=predacious=predacious
raptus=trance=trance
ras=headland=headland
rasure=act of scraping=scraping
rathe=quick=quick
ratihabition=ratification=ratification
rebarbative=repellent=repellent
rebatement=abatement=abatement
reboant=marked by reverberation=reverberation
recadency=relapsing=relapsing
recaption=reprisal=reprisal
recoct=to cook again=cook
recreant=craven=craven
recrement=waste=waste
recte=correctly=correctly
recumbent=reclining=reclining
recure=to cure=cure
redact=to edit=edit
redargue=to refute=refute
redivivus=resuscitated=resuscitated
redolent=fragrant=fragrant
redoubtable=formidable=formidable
refel=to refute=refute
reflexology=study of reflexes=reflexes
reflux=an ebb=ebb
refocillate=to refresh=refresh
refractory=unruly=unruly
refringency=refractivity=refractivity
regius=royal=royal
reglementation=regulation=regulation
regnal=of a reign=reign
regorge=to disgorge=disgorge
regrede=to retrograde=retrograde
reguerdon=to reward=reward
rejectamenta=refuse=refuse
relâche=relaxation=relaxation
reliquiae=remains=remains
relucent=reflecting=reflecting
remanent=a remainder=remainder
remeant=returning=returning
remigate=to row=row
remonstrate=to protest=protest
remora=delay=delay
remotion=separation=separation
remuant=restless=restless
renitent=resistant=resistant
renverse=to reverse=reverse
reprehend=to rebuke=rebuke
reptant=creeping=creeping
repugn=to fight against=fight
reremouse=bat=bat
resiant=resident=resident
resile=to recoil=recoil
resipiscence=recognition of error=recognition
retiary=of nets=nets
reticular=pertaining to nets=nets
retiracy=seclusion=seclusion
retrad=backwards=backwards
retrenchment=cutting down on=cutting
retro=in the past=past
retroussé=turned up=turned
revalescent=convalescent=convalescent
revanche=revenge=revenge
revest=reinstate=reinstate
reviviscent=reviving=reviving
rhabdoid=rodlike=rodlike
rhaebosis=curvature=curvature
rhema=word=word
rheumatology=study of rheumatism=rheumatism
rhigosis=sensation of cold=sensation
rhinocerial=very heavy=heavy
rhonchial=pertaining to snoring=snoring
rhubarb=nonsense=nonsense
riant=laughing=laughing
rictal=of the gape=gape
rimose=full of chinks=full
rimple=to wrinkle=wrinkle
ringent=gaping=gaping
rinkomania=obsession with skating=skating
risible=laughable=laughable
risorgimento=revival=revival
risus=a laugh=laugh
rivage=shore=shore
rivel=to shrivel=shrivel
roborate=to strengthen=strengthen
roborean=strong=strong
rodenticide=killing of rodents=rodents
rodomontade=bluster=bluster
rolly=truck=truck
romage=tumult=tumult
rooibok=impala=impala
rookery=state of confusion=state
roric=dewy=dewy
roscid=dewy=dewy
roseate=resembling a rose=rose
rosorial=rodentine=rodentine
rota=roster=roster
rottack=rubbish=rubbish
rotula=kneecap=kneecap
rotundate=rounded off=rounded
roturier=plebeian=plebeian
rowel=small=small
rubedinous=ruddy=ruddy
rubefaction=reddening=reddening
rubefy=to redden=redden
rubicund=ruddy=ruddy
rubigo=mildew=mildew
rubinetto=faucet=faucet
rubricality=ceremony=ceremony
rubster=lesbian=lesbian
ruction=disturbance=disturbance
rufescent=inclining to redness=redness
rugate=wrinkled=wrinkled
rugible=capable of roaring=roaring
rugine=surgeon's scraping instrument=surgeon
rugous=wrinkled=wrinkled
rumbustious=boisterous=boisterous
runagate=fugitive=fugitive
runcation=action of weeding=weeding
runology=study of runes=runes
rupellary=rocky=rocky
rupestrian=composed of rock=rock
rupicaprine=pertaining to chamoises=chamoises
ruth=pity=pity
ruthful=piteous=piteous
rutidosis=wrinkling=wrinkling
rutilant=shining=shining
sable=black=black
sabulous=sandy=sandy
saccadic=jerky=jerky
sacerdotal=priestly=priestly
sacring=hallowing=hallowing
sadogue=fat=fat
sagittary=centaur=centaur
sal=a salt=salt
salamandroid=like a salamander=salamander
salsitude=saltiness=saltiness
salsuginous=salty=salty
saltant=leaping=leaping
saltationism=punctuation in evolution=punctuation
saltativeness=ability to jump=jump
saltigrade=progressing by leaps=progressing
saltus=breach of continuity=continuity
salvo=excepting=excepting
samel=underburnt=underburnt
sanative=healing=healing
sanctanimity=holiness of mind=mind
sangfroid=coolness=coolness
sanguine=optimistic=optimistic
sanguineous=bloody=bloody
sapience=discernment=discernment
saponaceous=soapy=soapy
Sapphism=homosexuality in women=women
sarcophagous=feeding on flesh=flesh
sarcophilous=fond of flesh=fond
satisdation=provision of security=security
sative=cultivated=cultivated
sauf=except for=except
sawder=to flatter=flatter
saxigenous=growing in rocks=rocks
scacchic=pertaining to chess=chess
scaffmaster=steward=steward
scandent=climbing=climbing
scansorial=climbing=climbing
scapegrace=scoundrel=scoundrel
scaphion=kind of sundial=sundial
scapigerous=having a scape=scape
scarabaean=pertaining to scarabs=scarabs
scaramouch=ruffian=ruffian
scarious=thin and tough=tough
scatch=a stilt=stilt
scattery=dispersed=dispersed
scaturient=flowing out=flowing
scaturiginous=abounding with springs=springs
scelerat=villain=villain
scelestic=wicked=wicked
schistous=formed of schist=schist
schizogenesis=reproduction by division=reproduction
schizotrichia=splitting of hair=splitting
schmegeggy=nonsense=nonsense
scholiast=commentator=commentator
schorl=tourmaline=tourmaline
sciagraphy=art of shading=shading
sciaphobia=fear of shadows=shadows
scilicet=to wit=wit
scincoid=of  a skink=skink
scintilla=hint=hint
scintillant=sparkling=sparkling
scintillescent=twinkling=twinkling
scission=cutting=cutting
scissure=a cleft=cleft
sciurine=pertaining to squirrels=squirrels
scleroid=hard=hard
scolopacine=pertaining to snipes=snipes
scopic=visual=visual
scortation=fornication=fornication
scranch=to crunch=crunch
scrannel=thin=thin
scribacious=given to writing=given
scribbleomania=obsession with scribbling=scribbling
scrimure=fencer=fencer
scriniary=keeper of archives=keeper
scriptory=pertaining to writing=pertaining
scrivello=elephant's tusk=tusk
scrow=a scroll=scroll
scullion=mean=mean
scurriour=scout=scout
scutal=pertaining to shields=shields
scutiger=squire=squire
seahog=porpoise=porpoise
secreta=products of secretion=secretion
secundine=afterbirth=afterbirth
secundum=according to=according
securigerous=bearing an axe=bearing
secus=otherwise=otherwise
sedent=seated=seated
sedimentology=study of sediment=sediment
sedulous=assiduous=assiduous
seen=considering=considering
segnity=sluggishness=sluggishness
seismology=study of earthquakes=earthquakes
seity=self=self
sejugate=to separate=separate
sejunction=separation=separation
selcouth=strange=strange
sellate=having a saddle=saddle
semantics=study of meaning=meaning
semasiology=study of meaning=meaning
semovedly=separately=separately
semper=always=always
sempervirent=evergreen=evergreen
sempster=one who sews=sews
senectuous=very old=old
sensile=sentient=sentient
sententia=opinion=opinion
sententious=full of meaning=meaning
sepelition=burial=burial
sepian=inky=inky
sepicolous=dwelling in hedges=hedges
sepiment=hedge=hedge
septate=partitioned=partitioned
septemfid=split into seven=split
septentrional=northern=northern
septiferous=having barriers=barriers
septimanal=weekly=weekly
septum=division=division
sepulchral=funereal=funereal
sepultre=interment=interment
sequestrate=to confiscate=confiscate
seraglio=harem=harem
seraphic=serene=serene
sere=threadbare=threadbare
seriate=in rows=rows
seriatim=in succession=succession
seric=silken=silken
sericeous=silky=silky
sericulture=breeding of silkworms=silkworms
serment=oath=oath
serology=study of serums=serums
serous=pertaining to serum=serum
serpentiferous=bearing a snake=snake
serpentise=to wind=wind
serpigo=ringworm=ringworm
serratic=like a saw=saw
servitor=one who serves=serves
setose=bristly=bristly
severalty=separateness=separateness
sevum=tallow=tallow
shail=to shamble=shamble
shambles=a butcher's shop=shop
shambolic=chaotic=chaotic
shaugh=thicket=thicket
shend=to destroy=destroy
sheol=hell=hell
shopocracy=government by shopkeepers=shopkeepers
shuck=nonsense=nonsense
sialic=pertaining to saliva=saliva
sibylline=prophetic=prophetic
sic=thus=thus
sicarian=murderer=murderer
siccaneous=dry=dry
siccar=sure=sure
siccative=drying=drying
siffilate=to whistle=whistle
sigillate=sealed=sealed
sigillography=study of seals=seals
signary=system of symbols=system
signate=distinct=distinct
significs=science of meaning=meaning
silvicolous=living in woods=woods
silviculture=growing of trees=trees
simian=pertaining to apes=apes
similize=to liken=liken
simous=having a flat=flat
simpliciter=simply=simply
simpliciter=simply=simply
simpliste=simplistic=simplistic
simular=counterfeit=counterfeit
sinapise=to sprinkle=sprinkle
sinciput=the forehead=forehead
sine=without=without
singillatim=singly=singly
singult=a sob=sob
singultous=hiccuping=hiccuping
sinistrad=towards the left=towards
Sinology=study of China=china
siphonogamous=reproducing by seeds=seeds
sipidity=savour=savour
siriasis=sunstroke=sunstroke
siserary=a scolding=scolding
sith=since=since
sitiophobia=fear of food=food
sitology=dietetics=dietetics
situs=position=position
skean=dagger=dagger
skelder=to beg=beg
skeletogenous=producing a skeleton=skeleton
skellum=villain=villain
skittles=rubbish=rubbish
slantindicular=slanting=slanting
slatternly=slovenly=slovenly
sleathy=slovenly=slovenly
sley=weaver's reed=weaver
slickenside=smooth=smooth
smectic=purifying=purifying
sneap=to nip=nip
snell=quick=quick
snift=to sniff=sniff
snobocracy=government by snobs=snobs
sobeit=provided that=provided
sobriquet=nickname=nickname
socius=member=member
soilure=stain=stain
soldatesque=soldierlike=soldierlike
solidary=marked by solidarity=solidarity
soliloquent=speaking in soliloquies=speaking
sollevation=insurrection=insurrection
solmisate=to sing=sing
solum=ground=ground
solus=alone=alone
somatism=materialism=materialism
somatism=materialism=materialism
somedeal=somewhat=somewhat
somewhither=to some place=place
sommelier=butler=butler
somnial=pertaining to dreams=dreams
somniate=to dream=dream
somnolence=sleepiness=sleepiness
sonance=sound=sound
sooth=truth=truth
soothfast=truthful=truthful
soothly=in truth=truth
sophianic=pertaining to wisdom=wisdom
sophic=full of wisdom=wisdom
sophiology=science of ideas=ideas
sophomoric=bombastic=bombastic
sophrosyne=soundness of mind=soundness
sopite=to dull=dull
soporose=sleepy=sleepy
sord=flock of mallard=mallard
sordor=refuse=refuse
soricine=pertaining to shrews=shrews
sororal=pertaining to sisters=sisters
sorosis=women's club=women
sortation=sorting out=sorting
sortition=casting of lots=lots
soterial=pertaining to salvation=salvation
sough=drain=drain
sounder=herd of pigs=pigs
soutane=priest's cassock=priest
sovenance=remembrance=remembrance
spadassin=swordsman=swordsman
spagyric=alchemical=alchemical
spagyrist=alchemist=alchemist
spancel=to hobble=hobble
spaniolate=to hispanicize=hispanicize
spargosis=swelling=swelling
spatiate=to ramble=ramble
spavined=lame=lame
spectrology=study of ghosts=ghosts
spectroscopy=study of spectra=spectra
specular=mirrorlike=mirrorlike
speculum=mirror=mirror
speed=prosperity=prosperity
spelter=zinc=zinc
speluncar=pertaining to caves=caves
spermatic=pertaining to sperm=sperm
spermology=study of seeds=seeds
sphacelated=necrosed=necrosed
sphingal=pertaining to sphinxes=sphinxes
sphygmodic=pulsating=pulsating
sphygmus=the pulse=pulse
spicate=spiked=spiked
spiflicate=to destroy=destroy
spiloma=birthmark=birthmark
spinach=nonsense=nonsense
spinosity=thorniness=thorniness
spirate=voiceless=voiceless
spiration=act of breathing=breathing
spissated=thickened=thickened
spissitude=density=density
splanchnic=visceral=visceral
splenitive=fiery=fiery
spoliate=to despoil=despoil
spondyle=vertebra=vertebra
spongology=study of sponges=sponges
sponsal=spousal=spousal
sponsalia=espousals=espousals
sporicide=killing of spores=spores
spraints=otters' dung=otters
sprauncy=smart=smart
sprent=sprinkled=sprinkled
spumescent=foamy=foamy
spumid=frothy=frothy
spurcitious=foul=foul
squab=fat=fat
squaloid=pertaining to sharks=sharks
squamate=scaly=scaly
squamation=scaliness=scaliness
squamoid=like a scale=scale
squatterarchy=government by squatters=squatters
squattocracy=government by squatters=squatters
squinancy=quinsy=quinsy
squirearchy=government by squires=squires
squirocracy=government by squires=squires
stabile=stationary=stationary
stang=stake=stake
stasiarch=ringleader in sedition=sedition
stat=immediately=immediately
statim=immediately=immediately
statuminate=to support=support
statuvolism=mesmerism=mesmerism
steatite=soapstone=soapstone
steganograph=cryptogram=cryptogram
steganographer=cryptographer=cryptographer
stegnosis=constipation=constipation
stemma=scroll=scroll
stenotone=breve=breve
stercoraceous=pertaining to feces=feces
stercorate=to shit=shit
stereobate=substructure=substructure
stereophony=reproduction of sound=sound
sternutation=sneezing=sneezing
steven=outcry=outcry
sthenia=strength=strength
sthenic=strong=strong
stibial=pertaining to antimony=antimony
stillatim=drop by drop=drop
stillatitious=issuing in drops=issuing
stillatory=still=still
stillicide=drip=drip
stipe=a stalk=stalk
stokehold=ship's furnace chamber=ship
stomachous=resentful=resentful
stotious=drunk=drunk
stover=fodder=fodder
strabismus=squint=squint
strait=strict=strict
stramineous=strawy=strawy
stratiform=layered=layered
stratous=in layers=layers
strepent=noisy=noisy
strepitant=loud=loud
strepor=noise=noise
strepsis=twisting=twisting
striated=striped=striped
stridulous=squeaky=squeaky
strigate=bristled=bristled
strigilation=scraping=scraping
strophosis=twist=twist
strumpetocracy=government by strumpets=strumpets
struthious=pertaining to ostriches=ostriches
stulm=adit=adit
stupefacient=narcotic=narcotic
stupent=astounded=astounded
stuprate=to ravish=ravish
stupulose=downy=downy
styliferous=bearing a bristle=bristle
suasion=persuasion=persuasion
suaveolent=fragrant=fragrant
sub dio=outdoors=outdoors
sub rosa=secretly=secretly
subact=to work up=work
subalary=beneath the wings=wings
subboreal=very cold=cold
subdolous=crafty=crafty
subduct=to withdraw=withdraw
suberic=pertaining to cork=cork
subfusc=dusky=dusky
subindicate=to hind=hind
subitaneous=sudden=sudden
subjacent=underlying=underlying
sublate=to deny=deny
sublineation=act of underlining=underlining
sublunary=under the moon=moon
subniveal=under snow=snow
subnubilar=under clouds=clouds
subreptary=adapted to crawling=crawling
subreption=misrepresentation=misrepresentation
subrident=smiling=smiling
subrogate=to substitute=substitute
subsecive=remaining over=remaining
subsolar=beneath the sun=sun
substractor=detractor=detractor
subternatural=less than natural=natural
suburbicarian=pertaining to suburbs=suburbs
succedaneum=substitute=substitute
succiduous=ready to fall=ready
succursal=subsidiary=subsidiary
succuss=to shake up=shake
sudation=sweating=sweating
sudor=sweat=sweat
sudoral=sweaty=sweaty
sudorous=sweaty=sweaty
suffisance=sufficiency=sufficiency
sufflaminate=to check=check
sufflate=to inflate=inflate
sugent=designed for sucking=sucking
suicidology=study of suicide=suicide
suidian=pertaining to pigs=pigs
suilline=like a pig=pig
sulcal=of a sulcus=sulcus
sulcalize=to furrow=furrow
sullage=filth=filth
sulphorous=pertaining to hellfire=hellfire
supellex=furnishings=furnishings
supercherie=deception=deception
supercrescent=parasitic=parasitic
superfuse=to pour over=pour
superincumbent=resting on top=top
superjacent=lying above=lying
superjection=exaggeration=exaggeration
superlunary=otherworldly=otherworldly
supernal=on high=high
suppalpation=coaxing=coaxing
suppletion=addition=addition
suppliant=supplicating=supplicating
suppositious=conjectural=conjectural
supraliminal=conscious=conscious
supralunar=beyond the moon=moon
surculation=pruning=pruning
surd=deaf=deaf
surfeit=excess=excess
surnominal=pertaining to surnames=surnames
surquedry=arrogance=arrogance
suscitate=to excite=excite
suspercollate=to hang=hang
suspiration=sighing=sighing
sustentacular=supporting=supporting
sustentative=sustaining=sustaining
susurrate=to whisper=whisper
susurrus=murmuring=murmuring
sutor=cobbler=cobbler
swage=groove=groove
swink=to toil=toil
swith=instantly=instantly
sybaritic=devoted to luxury=luxury
syllabatim=syllable by syllable=syllable
sylvestral=pertaining to trees=trees
sylviculture=forestry=forestry
symbology=study of symbols=symbols
symmetrophobia=fear of symmetry=symmetry
symptomatography=description of symptoms=symptoms
symptosis=emaciation=emaciation
syncrasy=combination=combination
syndetic=connective=connective
synodical=pertaining to conjunction=conjunction
synonymicon=thesaurus=thesaurus
syntexis=liquefaction=liquefaction
syntomy=brevity=brevity
syphilology=study of syphilis=syphilis
syphilophobia=fear of syphilis=syphilis
syrt=quicksand=quicksand
syrtic=pertaining to quicksand=quicksand
systematology=study of systems=systems
tabellary=auditor=auditor
tabellion=scrivener=scrivener
tabescent=wasting=wasting
tabific=wasting=wasting
tablier=apron=apron
tacent=silent=silent
tach=link=link
tachygraphy=shorthand=shorthand
tachymetry=measurement of speed=speed
taction=contact=contact
taenia=band=band
taeniacide=killing of tapeworms=tapeworms
talionic=retributive=retributive
tanti=worthwhile=worthwhile
tappit=crested=crested
tarradiddle=lie=lie
tatonnement=experimentation=experimentation
tatou=armadillo=armadillo
tatterdemalion=tattered=tattered
taurine=pertaining to bulls=bulls
tauromachy=bullfighting=bullfighting
technomania=craze for technology=technology
technophobia=fear of technology=technology
tecnology=teaching of children=teaching
tectonic=pertaining to building=building
tectorial=covering=covering
tediferous=bearing a torch=torch
teen=injury=injury
tegminal=covering=covering
tegula=tile=tile
teleorganic=vital=vital
tellurian=terrestrial=terrestrial
telmatology=study of swamps=swamps
telos=aim=aim
tempestive=timely=timely
temporise=to delay=delay
temulence=intoxication=intoxication
tenaculum=pincers=pincers
tenebrose=dark=dark
tentamen=experiment=experiment
tentigo=priapism=priapism
tenue=bearing=bearing
tephromancy=divination by ashes=divination
tephrosis=incineration=incineration
teratoid=monstrous=monstrous
terebrate=to bore into=bore
tergiversation=equivocation=equivocation
ternary=in threes=threes
terpsichorean=pertaining to dancing=dancing
terraceous=earthen=earthen
terraqueous=amphibious=amphibious
terremotive=seismic=seismic
terrene=of the earth=earth
terrigenous=produced on land=produced
tersive=cleansing=cleansing
tetchy=irritable=irritable
tetrachotomous=divided into fours=fours
tetrapod=quadruped=quadruped
teuthology=study of cephalopods=cephalopods
tewel=a chimney=chimney
textorial=pertaining to weaving=weaving
textrine=pertaining to weaving=weaving
thalassian=marine=marine
thalassic=marine=marine
thalposis=sensation of warmth=warmth
thanatophobia=fear of death=death
thanatosis=gangrene=gangrene
thaumatology=study of miracles=miracles
thaumaturgy=performing of miracles=performing
theca=sheath=sheath
thecate=having a sheath=sheath
theftuous=thievish=thievish
thelemite=libertine=libertine
theocrasy=mixture of religions=religions
theodidact=student of God=student
theogamy=marriage of gods=marriage
theophobia=fear of God=god
thereoid=bestial=bestial
thereology=therapeutics=therapeutics
thereon=thereupon=thereupon
therewith=thereupon=thereupon
therewithal=besides=besides
theriacal=pertaining to antidotes=antidotes
theriodic=malignant=malignant
thermic=pertaining to heat=heat
thermogenesis=production of heat=production
thermology=study of heat=heat
thermoplagia=sunstroke=sunstroke
thersitical=scurrilous=scurrilous
thither=to that place=place
thlipsis=constriction=constriction
thole=to endure=endure
thooid=like a wolf=wolf
thrasonic=boastful=boastful
threnetic=mournful=mournful
threnodic=mournful=mournful
threpsology=science of nutrition=nutrition
thurible=censer=censer
thyestean=cannibalistic=cannibalistic
thymogenic=due to emotion=emotion
tidology=study of tides=tides
tigerism=swagger=swagger
tigrine=pertaining to tigers=tigers
timbrous=resonant=resonant
timoneer=helmsman=helmsman
tinction=act of dyeing=dyeing
tinctorial=pertaining to dyeing=dyeing
tinctumutation=change of colour=colour
tinnient=ringing=ringing
tintinnabulate=to ring=ring
tirailleur=skirmisher=skirmisher
tiro=recruit=recruit
tisicky=wheezy=wheezy
titivate=dress up=dress
titrimetry=measuring by titration=titration
titubate=to stagger=stagger
tocology=obstetrics=obstetrics
tofore=previously=previously
togated=wearing a toga=wearing
toison=lamb's wool=wool
tolypeutine=pertaining to armadillos=armadillos
toman=myriad=myriad
tonant=thundering=thundering
tonetics=study of pronunciation=pronunciation
tonish=modish=modish
tonitrophobia=fear of thunder=thunder
tonitruous=thundering=thundering
tophaceous=gritty=gritty
toplofty=high and mighty=mighty
torcular=tourniquet=tourniquet
torose=swelling=swelling
torpedinous=numbing=numbing
torpid=numb=numb
torpor=numbness=numbness
tortile=wreathed=wreathed
torvity=grimness=grimness
torvous=stern=stern
tosh=rubbish=rubbish
tosticated=fuddled=fuddled
totipotent=capable of differentiation=differentiation
tourbillon=swirl=swirl
tournure=contour=contour
tovarish=comrade=comrade
toxicophobia=fear of poisoning=poisoning
toxophilite=lover of archery=lover
toxophily=love of archery=archery
toze=to tease out=tease
tracasserie=turmoil=turmoil
trachelate=having a neck=neck
trachyphonia=roughness of voice=voice
tractate=treatise=treatise
tractile=ductile=ductile
traditive=traditional=traditional
traduce=to defame=defame
traductive=transmitted=transmitted
trahison=treachery=treachery
traject=crossing=crossing
tralatition=metaphor=metaphor
tralatitious=traditional=traditional
tralineate=to deviate=deviate
tramontane=beyond the mountains=mountains
tranect=ferry=ferry
tranq=tranquilizer=tranquilizer
translunary=beyond the moon=moon
transpicuous=transparent=transparent
transude=to ooze out=ooze
transumption=transcription=transcription
transverberate=to pierce=pierce
traulism=stammering=stammering
traverse=across=across
treacle=dark=dark
tregetour=juggler=juggler
trema=an orifice=orifice
tremallose=gelatinous=gelatinous
tremulous=trembling=trembling
trenchant=incisive=incisive
tressilate=to quiver=quiver
trichoclasis=brittleness of hair=hair
trichoschisis=splitting of hair=splitting
trin=triplet=triplet
tringoid=pertaining to sandpipers=sandpipers
tripsis=pulverization=pulverization
trismus=lockjaw=lockjaw
tritical=trite=trite
triune=trinity=trinity
trochilidine=pertaining to hummingbirds=hummingbirds
trochiline=pertaining to hummingbirds=hummingbirds
trochlear=like a pulley=pulley
troglodytine=pertaining to wrens=wrens
trophism=nutrition=nutrition
trophology=study of nutrition=nutrition
tropic=like a keel=like
trottoir=pavement=pavement
trucidation=slaughter=slaughter
truckle=to submit=submit
truculent=belligerent=belligerent
trumpery=deception=deception
truttaceous=pertaining to trout=trout
trypanocide=killing of trypanosomes=trypanosomes
tsiganology=study of gypsies=gypsies
tsiology=treatise on tea=treatise
tuberous=having tubers=tubers
tubicolous=inhabiting a tube=tube
tubifacient=constructing a tube=tube
tufthunter=toady=toady
tuism=apostrophe=apostrophe
tulipomania=obsession with tulips=tulips
tumefy=to swell=swell
tumescent=tending to swell=tending
tumid=inflated=inflated
tumultuary=chaotic=chaotic
tund=to beat=beat
tunicate=covered with layers=layers
tup=ram=ram
turdiform=like a thrush=thrush
turdine=pertaining to thrushes=thrushes
turgent=swollen=swollen
turgid=swollen=swollen
tussicular=pertaining to coughs=coughs
twaddle=rubbish=rubbish
twain=two=two
twiforked=bifurcate=bifurcate
twingle=to wriggle=wriggle
twink=to blink=blink
twire=to peep=peep
twizzle=to swirl=swirl
tyloma=callus=callus
tyriasis=elephantiasis=elephantiasis
uberty=fruitfulness=fruitfulness
ubi=whereabouts=whereabouts
ubicity=whereabouts=whereabouts
ubiety=location=location
ubique=everywhere=everywhere
ukase=edict=edict
uliginous=slimy=slimy
ullagone=cry of lamentation=lamentation
uloid=like a scar=scar
ultion=revenge=revenge
ultroneous=spontaneous=spontaneous
umbe=around=around
umbracious=shady=shady
umbrage=shade=shade
umbratic=shadowy=shadowy
umbratilous=shadowy=shadowy
umstroke=circumference=circumference
unbosom=to pour out=pour
uncate=hooked=hooked
unconsentaneous=not in agreement=agreement
unctuous=slimy=slimy
undate=wavy=wavy
undight=to take off=take
uneath=difficult=difficult
unguentary=pertaining to unguents=unguents
unguiculate=clawed=clawed
unguicule=fingernail=fingernail
unguinous=oily=oily
unguligrade=walking on hoofs=walking
unicity=uniqueness=uniqueness
unicornic=resembling a unicorn=unicorn
unition=conjunction=conjunction
univocal=unmistakeable=unmistakeable
unleal=unfaithful=unfaithful
unprevaricate=not perverted=perverted
unstercorated=not manured=manured
untimeous=untimely=untimely
untreasure=to despoil=despoil
unwithdrawing=liberal=liberal
unzymotic=fabulous=fabulous
upaithric=roofless=roofless
upbuilding=development=development
uprist=rising=rising
upstay=to sustain=sustain
upwith=up along=along
uranic=of the palate=palate
uranophobia=fear of heaven=heaven
uraster=starfish=starfish
urbanology=study of cities=cities
urbicolous=dwelling in cities=dwelling
urdé=pointed=pointed
ure=use=use
urent=burning=burning
uresis=urination=urination
uretic=pertaining to urine=urine
urinator=diver=diver
urology=study of urine=urine
ursine=pertaining to bears=bears
urticaceous=pertaining to nettles=nettles
urticant=stinging=stinging
urticate=to sting=sting
usance=habit=habit
ustulation=burning=burning
utile=profitable=profitable
uvid=moist=moist
vacatur=annulment=annulment
vaccinal=relating to vaccination=vaccination
vaccine=pertaining to cows=cows
vacive=empty=empty
vacky=evacuee=evacuee
vacuity=emptiness=emptiness
vadelect=servant=servant
vafrous=cunning=cunning
vagant=roaming, wandering=wandering
vaginate=sheathed=sheathed
vagous=irregular, unsettled=unsettled
vagulate=to wander=wander
valetaille=group of valets=valets
valienton=bully, braggard=bully
vallidom=worth, value=worth
vallum=rampart=rampart
vapulate=to flog=flog
vapulatory=pertaining to flogging=flogging
varec=seaweed=seaweed
varia=miscellany=miscellany
variegated=diverse and varied=varied
variola=smallpox=smallpox
varsal=whole=whole
vasculum=botanist's collecting case=botanist
vastidity=vastness=vastness
vasy=slimy=slimy
vatic=prophetic=prophetic
vaticinate=prophesy=prophesy
vaticiny=a prophecy=prophecy
vauntage=bragging=bragging
vauntiness=boastfulness=boastfulness
vauqueline=strychnine=strychnine
vecordy=madness, folly=madness
vegete=vigorous=vigorous
velate=having a veil=veil
velation=act of veiling=veiling
velitation=skirmish=skirmish
velivolant=flying with sails=sails
vellicate=to twitch=twitch
velutinous=velvety=velvety
venatic=pertaining to hunting=hunting
venator=huntsman=huntsman
vendee=purchaser=purchaser
venditation=offering for sale=sale
vendition=sale=sale
venenation=poisoning=poisoning
venerance=venerability=venerability
venerative=disposed to veneration=veneration
venerer=gamekeeper=gamekeeper
venerous=lustful=lustful
venial=pardonable=pardonable
venireman=juror=juror
venose=veiny=veiny
venous=pertaining to veins=veins
ventana=window=window
ventilabral=pertaining to fans=fans
ventorious=characterized by venturesomeness=venturesomeness
ventose=windy=windy
ventrad=towards the front=towards
veracious=truthful=truthful
verbarian=coiner of words=words
verbatim=word for word=word
verberate=to beat=beat
verbomania=craze for words=words
verdure=greenness=greenness
verecund=modest=modest
veridical=veracious=veracious
veridicous=truthful=truthful
verily=truly=truly
vermeology=study of worms=worms
vermian=like a worm=worm
vermicide=killing of worms=worms
vermicular=pertaining to worms=worms
vermiculous=wormy=wormy
vermiculture=cultivation of worms=worms
verminology=science of vermin=vermin
vernal=pertaining to spring=spring
vernition=varnishing=varnishing
verruca=wart=wart
verrucose=warty=warty
versative=flexible=flexible
versiform=changing in form=form
versute=crafty=crafty
verticil=whorl=whorl
verticillated=whorled=whorled
vertiginate=dizzy=dizzy
vertiginous=pertaining to vertigo=vertigo
vesica=a bladder=bladder
vesicant=blistering=blistering
vesicate=to blister=blister
vespal=pertaining to wasps=wasps
vesper=evening=evening
vespiary=wasp's nest=wasp
vestiture=clothes=clothes
vestry=priest's dressing room=priest
vesturer=keeper of vestments=vestments
vesuviate=to erupt=erupt
vetust=very ancient=ancient
vexillology=study of flags=flags
via=by way of=way
viator=traveller=traveller
vice=in place of=place
vicinage=neighbourhood=neighbourhood
vicinal=neighboring=neighboring
victimology=study of victims=victims
victoria=cry of triumph=triumph
videlicet=to wit=wit
videtur=it seems=seems
viduage=widowhood=widowhood
viduity=widowhood=widowhood
viduous=widowed=widowed
vigilous=pertaining to watching=watching
vignoble=vineyard=vineyard
vilipend=to despise=despise
villatic=rural=rural
villose=velvety=velvety
viminal=pertaining to twigs=twigs
vinca=periwinkle=periwinkle
vincture=something that binds=something
vincular=connective=connective
vineal=living on vines=vines
vineatic=pertaining to vines=vines
vinewed=mouldy=mouldy
vinolent=addicted to wine=wine
vinomadefied=soaked with wine=wine
violatic=flying about=flying
viperine=pertaining to vipers=vipers
viperous=pertaining to vipers=vipers
virgal=composed of twigs=twigs
virgate=rodlike=rodlike
viricide=killing of viruses=viruses
virid=green=green
viridity=greenness=greenness
virific=poisonous=poisonous
virology=study of viruses=viruses
virose=poisonous=poisonous
virucide=killing of viruses=viruses
vis=force=force
visile=pertaining to sight=sight
visive=pertaining to sight=sight
viticetum=plantation of vines=vines
viticolous=living on vines=vines
vitrifacture=glassblowing=glassblowing
vituperation=abuse=abuse
vivency=vitality=vitality
vivers=food=food
vizard=mask=mask
vocabularian=pertaining to vocabulary=vocabulary
vociferant=clamorous=clamorous
volage=giddy=giddy
volant=flying=flying
volary=aviary=aviary
volation=ability to fly=fly
volcanology=study of volcanoes=volcanoes
volitant=flying=flying
volitation=flying=flying
volitient=willing=willing
volitorial=able to fly=fly
voluble=fluent in speech=speech
volucrine=pertaining to birds=birds
voluptuary=sensualist=sensualist
volutation=action of rolling=rolling
vorago=gulf=gulf
vorant=devouring=devouring
vorpal=keen=keen
votation=action of voting=voting
votive=given by vow=vow
vraisemblance=verisimilitude=verisimilitude
vulcanology=study of volcanoes=volcanoes
vulgo=commonly=commonly
vulnerate=to wound=wound
vulnerose=wounded=wounded
vulpine=pertaining to foxes=foxes
vulturine=rapacious=rapacious
wakerife=wakeful=wakeful
wale=to choose=choose
wallfish=snail=snail
walm=to spout=spout
wanchancy=unlucky=unlucky
wang=the cheek=cheek
wanhope=despair=despair
wantage=deficiency=deficiency
wanze=to decrease=decrease
wapiti=elk=elk
warison=wealth=wealth
wastive=liable to waste=waste
waxcloth=oilcloth=oilcloth
wayment=lamentation=lamentation
wearish=tasteless=tasteless
weftage=texture=texture
welk=to twist about=twist
whelky=knobby=knobby
whemmle=to overturn=overturn
whicker=to neigh=neigh
whifflery=levity=levity
whiggarchy=government by Whigs=whigs
whilom=formerly=formerly
whin=gorse=gorse
whipcat=tailor=tailor
whippy=pliant=pliant
whither=to what place=place
whoreson=bastard=bastard
widdershins=counterclockwise=counterclockwise
wieldless=unmanageable=unmanageable
wight=nimble=nimble
wirble=to whirl=whirl
wisket=a basket=basket
wist=to know=know
wistly=longingly=longingly
withal=besides=besides
withy=flexible=flexible
womby=hollow=hollow
wonderwork=prodigy=prodigy
woning=state of dwelling=state
wontless=unaccustomed=unaccustomed
wood=mad=mad
woolbird=sheep=sheep
wordish=verbose=verbose
worksome=industrious=industrious
worricow=scarecrow=scarecrow
woundless=harmless=harmless
woundy=excessively=excessively
wrackful=destructive=destructive
wrawl=to caterwaul=caterwaul
wreakless=unpunished=unpunished
wrick=to twist=twist
wright=maker=maker
wristlet=wristband=wristband
writhled=wrinkled=wrinkled
wrongous=unjust=unjust
wroth=wrathful=wrathful
wrox=to decay=decay
wurley=a nest=nest
wurzel=kind of beet=kind
xanthic=yellow=yellow
xenagogue=guide=guide
xenodocheionology=love of hotels=hotels
xenodochial=hospitable=hospitable
xenophilia=love of foreigners=foreigners
xenophobia=fear of foreigners=foreigners
xenurine=species of armadillo=species
xeransis=drying up=drying
xeric=dry=dry
xerocopy=photocopy=photocopy
xerography=photocopying=photocopying
xerothermic=dry and hot=hot
xerotic=dry=dry
xesturgy=process of polishing=process
xilinous=pertaining to cotton=cotton
xiphias=swordfish=swordfish
xylary=pertaining to xylem=xylem
xylogenous=growing on wood=wood
xyloid=woody=woody
xylology=study of wood=wood
xylophilous=fond of wood=wood
yachty=relating to yachts=yachts
yapness=hunger=hunger
yarling=wailing=wailing
yarpha=peatbog=peatbog
yawl=ship's small boat=ship
yawny=prone to yawning=yawning
yeanling=lamb=lamb
yede=to go=go
yeep=to cheep=cheep
yellow=to bellow=bellow
yellowplush=a footman=footman
yeuk=to itch=itch
yieldless=unyielding=unyielding
yird=to bury=bury
yobbery=hooliganism=hooliganism
yogic=pertaining to yoga=yoga
yon=yonder=yonder
youster=to fester=fester
yuke=to itch=itch
zaftig=having a full=full
zakuska=hors d'oeuvre=oeuvre
zanyism=buffoonery=buffoonery
zapata=flowing, drooping moustache=flowing
zappy=lively=lively
zazzy=flashy=flashy
zebrine=pertaining to zebras=zebras
zebroid=like  a zebra=zebra
zelotypia=jealousy=jealousy
zendik=heretic=heretic
zetetic=proceeding by inquiry=proceeding
zingaro=gypsy=gypsy
zingiber=ginger=ginger
zirconic=pertaining to zirconium=zirconium
zizel=chipmunk=chipmunk
zizz=sparkle=sparkle
zoetic=living=living
zoic=pertaining to animals=animals
zonoid=like a zone=zone
zoochemistry=chemistry of animals=animals
zooculture=domestication of animals=domestication
zoodikers=an exclamation=exclamation
zoogenic=produced from animals=produced
zoometry=measurement of animals=measurement
zoopery=experimentation on animals=experimentation
zoophobia=fear of animals=animals
zootomy=dissection of animals=dissection
zoppa=syncopated=syncopated
zoster=a girdle=girdle
zucca=gourd=gourd
zygosis=conjugation=conjugation
zymic=pertaining to fermentation=fermentation
zymology=science of fermentation=fermentation
zymosis=fermentation=fermentation
zymotic=pertaining to fermentation=fermentation
